Waldstatt	AR
Trogen	AR
Travers	NE
Teufen	AR
Speicher	AR
Schwellbrunn	AR
Saint-Aubin-Sauges	NE
Rehetobel	AR
Peseux	NE
Neuchâtel	NE
La Chaux-de-Fonds	NE
Herisau	AR
Gorgier	NE
Gais	AR
Fontainemelon	NE
Fleurier	NE
Eggersriet	AR
Dombresson	NE
Cortaillod	NE
Chézard-Saint-Martin	NE
Cernier	NE
Bühler	AR
Boudry	NE
Bevaix	NE
Auvernier	NE
Bay Minette	AL
Edna	TX
Bayou La Batre	AL
Henderson	TX
Natalia	TX
Fort Hunt	VA
Brighton	AL
Ocean View	DE
Berry	AL
Trinity	FL
Villas	FL
Bessemer	AL
Aurora	IN
New Pekin	IN
Stockton	KS
Paducah	KY
Monticello	LA
Red Chute	LA
Jessup	MD
Birmingham	AL
Turpin Hills	OH
Lugoff	SC
Blountsville	AL
Blue Ridge	AL
Buda	TX
Boaz	AL
Brent	AL
Brewton	AL
Bridgeport	AL
Brookside	AL
Brookwood	AL
Brundidge	AL
Butler	AL
Bynum	AL
Cahaba Heights	AL
Calera	AL
Camden	AL
Camp Hill	AL
Carbon Hill	AL
Cedar Bluff	AL
Center Point	AL
Centre	AL
Centreville	AL
Chalkville	AL
Chatom	AL
Chelsea	AL
Cherokee	AL
Chickasaw	AL
Childersburg	AL
Citronelle	AL
Clanton	AL
Clay	AL
Clayton	AL
Cleveland	AL
Clio	AL
Coaling	AL
Collinsville	AL
Columbiana	AL
Concord	AL
Coosada	AL
Cordova	AL
Cottonwood	AL
Cowarts	AL
Creola	AL
Crossville	AL
Cullman	AL
Dadeville	AL
Daleville	AL
Daphne	AL
Dauphin Island	AL
Decatur	AL
Demopolis	AL
Dora	AL
Dothan	AL
East Brewton	AL
East Florence	AL
Eclectic	AL
Enterprise	AL
Eufaula	AL
Eutaw	AL
Evergreen	AL
Fairfield	AL
Fairhope	AL
Falkville	AL
Fayette	AL
Flint City	AL
Florala	AL
Florence	AL
Flomaton	AL
Foley	AL
Forestdale	AL
Fort Deposit	AL
Fort Payne	AL
Frisco City	AL
Fultondale	AL
Fyffe	AL
Gadsden	AL
Gardendale	AL
Geneva	AL
Georgiana	AL
Glencoe	AL
Good Hope	AL
Goodwater	AL
Gordo	AL
Grand Bay	AL
Grayson Valley	AL
Graysville	AL
Greensboro	AL
Greenville	AL
Grove Hill	AL
Guin	AL
Gulf Shores	AL
Guntersville	AL
Hackleburg	AL
Haleyville	AL
Hamilton	AL
Hanceville	AL
Harpersville	AL
Hartford	AL
Hartselle	AL
Harvest	AL
Hayneville	AL
Hazel Green	AL
Headland	AL
Heflin	AL
Helena	AL
Henagar	AL
Hokes Bluff	AL
Holt	AL
Homewood	AL
Hoover	AL
Hueytown	AL
Huguley	AL
Huntsville	AL
Indian Springs Village	AL
Inverness	AL
Irondale	AL
Jackson	AL
Jacksonville	AL
Jasper	AL
Jemison	AL
Killen	AL
Kimberly	AL
Kinsey	AL
Ladonia	AL
Lafayette	AL
Lake Purdy	AL
Lake View	AL
Lanett	AL
Leeds	AL
Level Plains	AL
Linden	AL
Lincoln	AL
Lineville	AL
Lipscomb	AL
Livingston	AL
Locust Fork	AL
Loxley	AL
Luverne	AL
Madison	AL
Malvern	AL
Margaret	AL
Marion	AL
McDonald Chapel	AL
Meadowbrook	AL
Meridianville	AL
Midfield	AL
Midland City	AL
Mignon	AL
Millbrook	AL
Millport	AL
Minor	AL
Mobile	AL
Monroeville	AL
Montevallo	AL
Montgomery	AL
Moody	AL
Moores Mill	AL
Morris	AL
Mosses	AL
Moulton	AL
Moundville	AL
Mount Olive	AL
Mountain Brook	AL
Munford	AL
Muscle Shoals	AL
New Brockton	AL
New Hope	AL
New Market	AL
Newton	AL
North Bibb	AL
Northport	AL
Odenville	AL
Ohatchee	AL
Opelika	AL
Oneonta	AL
Opp	AL
Orange Beach	AL
Owens Cross Roads	AL
Oxford	AL
Ozark	AL
Parrish	AL
Pelham	AL
Pell City	AL
Phenix City	AL
Phil Campbell	AL
Piedmont	AL
Pinson	AL
Pleasant Grove	AL
Point Clear	AL
Prattville	AL
Priceville	AL
Prichard	AL
Ragland	AL
Rainbow City	AL
Rainsville	AL
Red Bay	AL
Reform	AL
Rehobeth	AL
Riverside	AL
Roanoke	AL
Robertsdale	AL
Rock Creek	AL
Rogersville	AL
Russellville	AL
Saks	AL
Samson	AL
Saraland	AL
Sardis City	AL
Satsuma	AL
Scottsboro	AL
Selma	AL
Sheffield	AL
Slocomb	AL
Smiths Station	AL
Smoke Rise	AL
Southside	AL
Spanish Fort	AL
Springville	AL
Steele	AL
Stevenson	AL
Sulligent	AL
Sumiton	AL
Sylacauga	AL
Sylvan Springs	AL
Sylvania	AL
Talladega	AL
Tallassee	AL
Tarrant	AL
Taylor	AL
Taylor	AL
Theodore	AL
Thomasville	AL
Thorsby	AL
Tillmans Corner	AL
Town Creek	AL
Trinity	AL
Troy	AL
Trussville	AL
Tuscaloosa	AL
Tuscumbia	AL
Tuskegee	AL
Union Springs	AL
Uniontown	AL
Valley	AL
Vernon	AL
Vestavia Hills	AL
Vincent	AL
Warrior	AL
Weaver	AL
Webb	AL
West Blocton	AL
Wetumpka	AL
White Hall	AL
Wilsonville	AL
Winfield	AL
York	AL
Alma	AR
Altheimer	AR
Arkadelphia	AR
Ash Flat	AR
Ashdown	AR
Atkins	AR
Augusta	AR
Bald Knob	AR
Barling	AR
Batesville	AR
Bay	AR
Bearden	AR
Beebe	AR
Bella Vista	AR
Bella Vista	AR
Benton	AR
Bentonville	AR
Berryville	AR
Blytheville	AR
Bono	AR
Booneville	AR
Brinkley	AR
Brookland	AR
Bryant	AR
Bull Shoals	AR
Cabot	AR
Calico Rock	AR
Camden	AR
Caraway	AR
Carlisle	AR
Cave City	AR
Cave Springs	AR
Cedarville	AR
Centerton	AR
Charleston	AR
Cherokee Village	AR
Clarendon	AR
Clarksville	AR
Clinton	AR
Coal Hill	AR
Conway	AR
Corning	AR
Crossett	AR
Danville	AR
Dardanelle	AR
De Queen	AR
De Witt	AR
Decatur	AR
Dermott	AR
Des Arc	AR
Diaz	AR
Dierks	AR
Dover	AR
Dumas	AR
Earle	AR
East End	AR
El Dorado	AR
Elkins	AR
Elm Springs	AR
England	AR
Eudora	AR
Eureka Springs	AR
Fairfield Bay	AR
Farmington	AR
Fayetteville	AR
Flippin	AR
Foreman	AR
Fordyce	AR
Forrest City	AR
Fort Smith	AR
Gassville	AR
Gentry	AR
Gibson	AR
Glenwood	AR
Gosnell	AR
Gould	AR
Gravel Ridge	AR
Gravette	AR
Green Forest	AR
Greenbrier	AR
Greenland	AR
Greenwood	AR
Gurdon	AR
Hamburg	AR
Hampton	AR
Harrisburg	AR
Harrison	AR
Haskell	AR
Hazen	AR
Heber Springs	AR
Helena	AR
Hope	AR
Horseshoe Bend	AR
Hot Springs	AR
Hot Springs Village	AR
Hoxie	AR
Hughes	AR
Huntsville	AR
Jacksonville	AR
Johnson	AR
Jonesboro	AR
Judsonia	AR
Kensett	AR
Kibler	AR
Lake City	AR
Lake Hamilton	AR
Lake Village	AR
Lamar	AR
Lavaca	AR
Leachville	AR
Lepanto	AR
Lewisville	AR
Lincoln	AR
Little Flock	AR
Little Rock	AR
Lonoke	AR
Lowell	AR
Luxora	AR
Magnolia	AR
Malvern	AR
Mammoth Spring	AR
Manila	AR
Mansfield	AR
Marianna	AR
Marion	AR
Marked Tree	AR
Marmaduke	AR
Marshall	AR
Marvell	AR
Maumelle	AR
Mayflower	AR
McAlmont	AR
McCrory	AR
McGehee	AR
Melbourne	AR
Mena	AR
Mineral Springs	AR
Monette	AR
Monticello	AR
Morrilton	AR
Mountain View	AR
Mountain Home	AR
Mulberry	AR
Murfreesboro	AR
Nashville	AR
Newark	AR
Newport	AR
North Crossett	AR
North Little Rock	AR
Ola	AR
Osceola	AR
Ozark	AR
Paragould	AR
Paris	AR
Parkin	AR
Pea Ridge	AR
Pea Ridge	AR
Perryville	AR
Piggott	AR
Pine Bluff	AR
Piney	AR
Pocahontas	AR
Pottsville	AR
Prairie Creek	AR
Prairie Grove	AR
Prescott	AR
Rector	AR
Redfield	AR
Rison	AR
Rockwell	AR
Rogers	AR
Russellville	AR
Salem	AR
Salem	AR
Searcy	AR
Shannon Hills	AR
Sheridan	AR
Siloam Springs	AR
Smackover	AR
Springdale	AR
Stamps	AR
Star City	AR
Stephens	AR
Stuttgart	AR
Sweet Home	AR
Texarkana	AR
Trumann	AR
Tuckerman	AR
Van Buren	AR
Vilonia	AR
Waldo	AR
Waldron	AR
Walnut Ridge	AR
Ward	AR
Warren	AR
West Crossett	AR
West Fork	AR
West Helena	AR
West Memphis	AR
White Hall	AR
Wrightsville	AR
Wynne	AR
Yellville	AR
Bear	DE
Bellefonte	DE
Blades	DE
Bridgeville	DE
Brookside	DE
Camden	DE
Claymont	DE
Clayton	DE
Delaware City	DE
Delmar	DE
Dover	DE
Edgemoor	DE
Elsmere	DE
Georgetown	DE
Glasgow	DE
Greenville	DE
Harrington	DE
Highland Acres	DE
Hockessin	DE
Kent Acres	DE
Laurel	DE
Lewes	DE
Long Neck	DE
Middletown	DE
Milford	DE
Millsboro	DE
Milton	DE
New Castle	DE
Newark	DE
Newport	DE
North Star	DE
Pike Creek	DE
Rehoboth Beach	DE
Riverview	DE
Rodney Village	DE
Seaford	DE
Selbyville	DE
Smyrna	DE
Wilmington	DE
Wilmington Manor	DE
Wyoming	DE
Alachua	FL
Altamonte Springs	FL
Alva	FL
Andover	FL
Anna Maria	FL
Apalachicola	FL
Apollo Beach	FL
Apopka	FL
Arcadia	FL
Archer	FL
Asbury Lake	FL
Astatula	FL
Astor	FL
Atlantic Beach	FL
Atlantis	FL
Auburndale	FL
Aventura	FL
Avon Park	FL
Azalea Park	FL
Babson Park	FL
Bagdad	FL
Bal Harbour	FL
Baldwin	FL
Bartow	FL
Bay Harbor Islands	FL
Bay Hill	FL
Bay Pines	FL
Bayonet Point	FL
Bayshore Gardens	FL
Beacon Square	FL
Bee Ridge	FL
Belle Glade	FL
Belle Glade Camp	FL
Belle Isle	FL
Belleair	FL
Belleair Beach	FL
Belleair Bluffs	FL
Belleview	FL
Bellview	FL
Beverly Hills	FL
Big Coppitt Key	FL
Big Pine Key	FL
Biscayne Park	FL
Bithlo	FL
Bloomingdale	FL
Blountstown	FL
Boca Del Mar	FL
Boca Pointe	FL
Boca Raton	FL
Bokeelia	FL
Bonifay	FL
Bonita Springs	FL
Bowling Green	FL
Boyette	FL
Boynton Beach	FL
Bradenton	FL
Bradenton Beach	FL
Brandon	FL
Brent	FL
Broadview Park	FL
Bronson	FL
Brookridge	FL
Brooksville	FL
Broward Estates	FL
Brownsville	FL
Buckhead Ridge	FL
Buckingham	FL
Bunche Park	FL
Bunnell	FL
Burnt Store Marina	FL
Bushnell	FL
Butler Beach	FL
Callaway	FL
Campbell	FL
Cape Canaveral	FL
Cape Coral	FL
Carol City	FL
Carrabelle	FL
Carrollwood Village	FL
Carver Ranches	FL
Casselberry	FL
Cedar Grove	FL
Celebration	FL
Century	FL
Century Village	FL
Charlotte Harbor	FL
Charlotte Park	FL
Chattahoochee	FL
Cheval	FL
Chiefland	FL
Chipley	FL
Christmas	FL
Chuluota	FL
Citrus Hills	FL
Citrus Park	FL
Citrus Ridge	FL
Citrus Springs	FL
Clearwater	FL
Clermont	FL
Clewiston	FL
Cleveland	FL
Cocoa	FL
Cocoa Beach	FL
Coconut Creek	FL
Combee Settlement	FL
Conway	FL
Cooper City	FL
Coral Gables	FL
Coral Springs	FL
Coral Terrace	FL
Cortez	FL
Country Walk	FL
Country Club	FL
Crescent City	FL
Crestview	FL
Crooked Lake Park	FL
Cross City	FL
Crystal Lake	FL
Crystal River	FL
Crystal Springs	FL
Cudjoe Key	FL
Cutler	FL
Cutler Ridge	FL
Cypress Gardens	FL
Cypress Lake	FL
Cypress Lakes	FL
Cypress Quarters	FL
Dade City	FL
Dania Beach	FL
Davenport	FL
Davie	FL
Daytona Beach	FL
Daytona Beach Shores	FL
De Funiak Springs	FL
De Land	FL
De Leon Springs	FL
DeBary	FL
Deerfield Beach	FL
Delray Beach	FL
Deltona	FL
Desoto Lakes	FL
Destin	FL
Doctor Phillips	FL
Doral	FL
Dover	FL
Dundee	FL
Dunedin	FL
Dunnellon	FL
Eagle Lake	FL
East Lake	FL
East Palatka	FL
East Pensacola Heights	FL
East Perrine	FL
Eastpoint	FL
Eatonville	FL
Edgewater	FL
Edgewood	FL
Eglin Village	FL
Egypt Lake-Leto	FL
El Portal	FL
Elfers	FL
Ellenton	FL
Englewood	FL
Ensley	FL
Estero	FL
Eustis	FL
Fairview Shores	FL
Feather Sound	FL
Fellsmere	FL
Fern Park	FL
Fernandina Beach	FL
Ferry Pass	FL
Fish Hawk	FL
Five Points	FL
Flagler Beach	FL
Floral City	FL
Florida City	FL
Florida Ridge	FL
Forest City	FL
Fort Lauderdale	FL
Fort Meade	FL
Fort Myers	FL
Fort Myers Beach	FL
Fort Myers Shores	FL
Fort Pierce	FL
Fort Walton Beach	FL
Fountainbleau	FL
Freeport	FL
Frostproof	FL
Fruit Cove	FL
Fruitland Park	FL
Fruitville	FL
Fussels Corner	FL
Gainesville	FL
Gandy	FL
Gateway	FL
Geneva	FL
Gibsonia	FL
Gibsonton	FL
Gifford	FL
Gladeview	FL
Glencoe	FL
Glenvar Heights	FL
Golden Gate	FL
Golden Glades	FL
Golden Lakes	FL
Goldenrod	FL
Gonzalez	FL
Goulding	FL
Goulds	FL
Graceville	FL
Greater Sun Center	FL
Green Cove Springs	FL
Greenacres City	FL
Gretna	FL
Grove City	FL
Groveland	FL
Gulf Breeze	FL
Gulf Gate Estates	FL
Gulfport	FL
Haines City	FL
Hallandale Beach	FL
Hamptons at Boca Raton	FL
Harbor Bluffs	FL
Harbour Heights	FL
Harlem	FL
Harlem Heights	FL
Havana	FL
Haverhill	FL
Hawthorne	FL
Hawthorne	FL
Heathrow	FL
Hernando	FL
Hernando Beach	FL
Hialeah	FL
Hialeah Gardens	FL
High Point	FL
High Springs	FL
Highland Beach	FL
Highland City	FL
Hiland Park	FL
Hill 'n Dale	FL
Hilliard	FL
Hillsboro Beach	FL
Hobe Sound	FL
Holden Heights	FL
Holiday	FL
Holly Hill	FL
Hollywood	FL
Holmes Beach	FL
Homestead	FL
Homosassa	FL
Homosassa Springs	FL
Howie In The Hills	FL
Hudson	FL
Hunters Creek	FL
Hypoluxo	FL
Immokalee	FL
Indialantic	FL
Indian Harbour Beach	FL
Indian River Estates	FL
Indian River Shores	FL
Indian Rocks Beach	FL
Indian Shores	FL
Indiantown	FL
Inglis	FL
Interlachen	FL
Inverness	FL
Inwood	FL
Iona	FL
Islamorada	FL
Ives Estates	FL
Jacksonville	FL
Jacksonville Beach	FL
Jan-Phyl Village	FL
Jasmine Estates	FL
Jasper	FL
Jensen Beach	FL
June Park	FL
Juno Beach	FL
Jupiter	FL
Kathleen	FL
Kendale Lakes	FL
Kendall	FL
Kendall Green	FL
Kenneth City	FL
Kensington Park	FL
Key Biscayne	FL
Key Largo	FL
Key West	FL
Keystone	FL
Keystone Heights	FL
Kings Point	FL
Kissimmee	FL
LaBelle	FL
Lacoochee	FL
Lady Lake	FL
Laguna Beach	FL
Lake Alfred	FL
Lake Belvedere Estates	FL
Lake Butler	FL
Lake Butter	FL
Lake City	FL
Lake Clarke Shores	FL
Lake Forest	FL
Lake Hamilton	FL
Lake Helen	FL
Lake Lorraine	FL
Lake Lucerne	FL
Lake Magdalene	FL
Lake Panasoffkee	FL
Lake Park	FL
Lake Placid	FL
Lake Sarasota	FL
Lake Mary	FL
Lake Wales	FL
Lake Worth	FL
Lake Worth Corridor	FL
Lakeland	FL
Lakeland Highlands	FL
Lakes by the Bay	FL
Lakeside	FL
Lakeside Green	FL
Lakewood Park	FL
Lakewood Park	FL
Land O' Lakes	FL
Lantana	FL
Largo	FL
Lauderdale Lakes	FL
Lauderdale-by-the-Sea	FL
Lauderhill	FL
Laurel	FL
Lecanto	FL
Leesburg	FL
Lehigh Acres	FL
Leisure City	FL
Lely	FL
Lely Resort	FL
Lighthouse Point	FL
Live Oak	FL
Lochmoor Waterway Estates	FL
Lockhart	FL
Longboat Key	FL
Longwood	FL
Loughman	FL
Lower Grand Lagoon	FL
Lutz	FL
Lynn Haven	FL
Macclenny	FL
Madeira Beach	FL
Madison	FL
Maitland	FL
Malabar	FL
Malone	FL
Manasota Key	FL
Manatee Road	FL
Mango	FL
Mangonia Park	FL
Marathon	FL
Marco	FL
Margate	FL
Marianna	FL
Mary Esther	FL
Masaryktown	FL
Mascotte	FL
Mayo	FL
McGregor	FL
Meadow Woods	FL
Medley	FL
Medulla	FL
Melbourne	FL
Melbourne Beach	FL
Melrose Park	FL
Memphis	FL
Merritt Island	FL
Mexico Beach	FL
Miami	FL
Miami Beach	FL
Miami Gardens	FL
Miami Gardens	FL
Miami Lakes	FL
Miami Shores	FL
Miami Springs	FL
Micco	FL
Midway	FL
Midway	FL
Middleburg	FL
Milton	FL
Mims	FL
Minneola	FL
Miramar	FL
Miramar Beach	FL
Mission Bay	FL
Molino	FL
Monticello	FL
Moore Haven	FL
Mount Dora	FL
Mount Plymouth	FL
Mulberry	FL
Myrtle Grove	FL
Naples	FL
Naples Manor	FL
Naples Park	FL
Naranja	FL
Neptune Beach	FL
New Port Richey	FL
New Smyrna Beach	FL
Newberry	FL
Niceville	FL
Nokomis	FL
Norland	FL
North Andrews Gardens	FL
North Bay Village	FL
North Brooksville	FL
North De Land	FL
North Fort Myers	FL
North Key Largo	FL
North Lauderdale	FL
North Miami	FL
North Miami Beach	FL
North Palm Beach	FL
North Port	FL
North Redington Beach	FL
North River Shores	FL
North Sarasota	FL
Oak Hill	FL
Oak Ridge	FL
Oakland	FL
Oakland Park	FL
Ocala	FL
Ocean City	FL
Ocean Ridge	FL
Ocoee	FL
Odessa	FL
Ojus	FL
Okeechobee	FL
Oldsmar	FL
Olga	FL
Olympia Heights	FL
Opa-locka	FL
Orange City	FL
Orange Park	FL
Orangetree	FL
Orlando	FL
Orlovista	FL
Ormond Beach	FL
Ormond-by-the-Sea	FL
Osprey	FL
Oviedo	FL
Pace	FL
Pahokee	FL
Palatka	FL
Palm Aire	FL
Palm Bay	FL
Palm Beach	FL
Palm Beach Gardens	FL
Palm Beach Shores	FL
Palm City	FL
Palm Coast	FL
Palm Harbor	FL
Palm Springs	FL
Palm Springs North	FL
Palm Valley	FL
Palmetto	FL
Palmetto Estates	FL
Palmona Park	FL
Panama City	FL
Panama City Beach	FL
Paradise Heights	FL
Parker	FL
Parkland	FL
Pebble Creek	FL
Pelican Bay	FL
Pembroke Park	FL
Pembroke Pines	FL
Pensacola	FL
Perry	FL
Pierson	FL
Pine Castle	FL
Pine Hills	FL
Pine Island Center	FL
Pine Island Ridge	FL
Pine Manor	FL
Pine Ridge	FL
Pine Ridge	FL
Pinecrest	FL
Pinellas Park	FL
Pinewood	FL
Placid Lakes	FL
Plant City	FL
Plantation	FL
Plantation	FL
Plantation	FL
Plantation Mobile Home Park	FL
Poinciana	FL
Polk City	FL
Pompano Beach	FL
Pompano Beach Highlands	FL
Ponce Inlet	FL
Port Charlotte	FL
Port La Belle	FL
Port Orange	FL
Port Richey	FL
Port Saint Joe	FL
Port Saint John	FL
Port Saint Lucie	FL
Port Salerno	FL
Pretty Bayou	FL
Princeton	FL
Progress Village	FL
Punta Gorda	FL
Punta Gorda Isles	FL
Punta Rassa	FL
Quincy	FL
Redington Beach	FL
Redington Shores	FL
Richmond Heights	FL
Richmond West	FL
Ridge Manor	FL
Ridge Wood Heights	FL
Ridgecrest	FL
Rio	FL
Riverview	FL
Riviera Beach	FL
Rock Island	FL
Rockledge	FL
Roseland	FL
Rotonda	FL
Royal Palm Beach	FL
Royal Palm Estates	FL
Ruskin	FL
Safety Harbor	FL
Saint Augustine	FL
Saint Augustine Beach	FL
Saint Augustine Shores	FL
Saint Cloud	FL
Saint George	FL
Saint James City	FL
Saint Pete Beach	FL
Saint Petersburg	FL
Samoset	FL
San Carlos Park	FL
Sandalfoot Cove	FL
Sanibel	FL
Sanford	FL
Sarasota	FL
Sarasota Springs	FL
Satellite Beach	FL
Sawgrass	FL
Schall Circle	FL
Scott Lake	FL
Seaside	FL
Sebastian	FL
Sebring	FL
Seffner	FL
Seminole	FL
Seminole Manor	FL
Sewall's Point	FL
Shady Hills	FL
Sharpes	FL
Siesta Key	FL
Silver Lake	FL
Silver Springs Shores	FL
Sky Lake	FL
Sneads	FL
Solana	FL
South Bay	FL
South Beach	FL
South Bradenton	FL
South Apopka	FL
South Brooksville	FL
South Daytona	FL
South Gate Ridge	FL
South Highpoint	FL
South Miami	FL
South Miami Heights	FL
South Palm Beach	FL
South Pasadena	FL
South Patrick Shores	FL
South Sarasota	FL
South Venice	FL
Southchase	FL
Southgate	FL
Southwest Ranches	FL
Spring Hill	FL
Springfield	FL
Stacey Street	FL
Starke	FL
Stock Island	FL
Stuart	FL
Sugarmill Woods	FL
Sun City Center	FL
Suncoast Estates	FL
Sunny Isles Beach	FL
Sunrise	FL
Sunset	FL
Sunshine Ranches	FL
Surfside	FL
Sweetwater	FL
Taft	FL
Tallahassee	FL
Tamarac	FL
Tamiami	FL
Tampa	FL
Tangelo Park	FL
Tarpon Springs	FL
Tavares	FL
Tavernier	FL
Taylor Creek	FL
Tedder	FL
Temple Terrace	FL
Tequesta	FL
Terra Mar	FL
The Crossings	FL
The Hammocks	FL
The Meadows	FL
The Villages	FL
Thonotosassa	FL
Three Lakes	FL
Three Oaks	FL
Tice	FL
Tierra Verde	FL
Timber Pines	FL
Titusville	FL
Town 'n' Country	FL
Treasure Island	FL
Trenton	FL
Twin Lakes	FL
Umatilla	FL
Union Park	FL
University Park	FL
Upper Grand Lagoon	FL
Valparaiso	FL
Valrico	FL
Vamo	FL
Venice	FL
Venice Gardens	FL
Vero Beach	FL
Villages of Oriole	FL
Villano Beach	FL
Vineyards	FL
Virginia Gardens	FL
Wabasso Beach	FL
Wahneta	FL
Warm Mineral Springs	FL
Warrington	FL
Washington Park	FL
Watertown	FL
Wauchula	FL
Waverly	FL
Wedgefield	FL
Weeki Wachee Gardens	FL
Wekiwa Springs	FL
Wekiva Springs	FL
Wellington	FL
Wesley Chapel	FL
West Bradenton	FL
West Chase	FL
West De Land	FL
West Little River	FL
West Melbourne	FL
West Miami	FL
West Palm Beach	FL
West Pensacola	FL
West Perrine	FL
West Samoset	FL
West Vero Corridor	FL
West and East Lealman	FL
Westchester	FL
Weston	FL
Westview	FL
Westwood Lake	FL
Wewahitchka	FL
Whiskey Creek	FL
Whisper Walk	FL
White City	FL
Whitfield	FL
Wildwood	FL
Williamsburg	FL
Williston	FL
Williston Highlands	FL
Willow Oak	FL
Wilton Manors	FL
Wimauma	FL
Windermere	FL
Winston	FL
Winter Beach	FL
Winter Garden	FL
Winter Haven	FL
Winter Park	FL
Winter Springs	FL
Woodville	FL
Wright	FL
Yalaha	FL
Yeehaw Junction	FL
Yulee	FL
Zellwood	FL
Zephyrhills	FL
Zolfo Springs	FL
Abbeville	GA
Acworth	GA
Adairsville	GA
Adel	GA
Alamo	GA
Albany	GA
Alma	GA
Alpharetta	GA
Americus	GA
Aragon	GA
Arcade	GA
Arlington	GA
Ashburn	GA
Athens	GA
Atlanta	GA
Auburn	GA
Augusta	GA
Austell	GA
Avondale Estates	GA
Bainbridge	GA
Baldwin	GA
Barnesville	GA
Baxley	GA
Belvedere Park	GA
Berkeley Lake	GA
Blackshear	GA
Blakely	GA
Bloomingdale	GA
Blue Ridge	GA
Bogart	GA
Bonanza	GA
Boston	GA
Bowdon	GA
Bowman	GA
Braselton	GA
Bremen	GA
Brooklet	GA
Broxton	GA
Brunswick	GA
Buena Vista	GA
Buford	GA
Butler	GA
Byron	GA
Cairo	GA
Calhoun	GA
Camilla	GA
Canton	GA
Carrollton	GA
Cartersville	GA
Cedartown	GA
Centerville	GA
Chamblee	GA
Chatsworth	GA
Chattanooga Valley	GA
Chester	GA
Chickamauga	GA
Clarkesville	GA
Clarkston	GA
Claxton	GA
Clayton	GA
Cleveland	GA
Cochran	GA
College Park	GA
Colquitt	GA
Columbus	GA
Comer	GA
Commerce	GA
Conley	GA
Conyers	GA
Cordele	GA
Cornelia	GA
Country Club Estates	GA
Country Club Estates	GA
Covington	GA
Cumming	GA
Cusseta	GA
Cuthbert	GA
Dacula	GA
Dahlonega	GA
Dalton	GA
Dallas	GA
Darien	GA
Davisboro	GA
Dawson	GA
Decatur	GA
Deenwood	GA
Demorest	GA
Dock Junction	GA
Donalsonville	GA
Doraville	GA
Douglas	GA
Douglasville	GA
Druid Hills	GA
Dublin	GA
Duluth	GA
Dunwoody	GA
East Dublin	GA
East Griffin	GA
East Point	GA
East Newnan	GA
Eastman	GA
Eatonton	GA
Edison	GA
Elberton	GA
Ellaville	GA
Ellijay	GA
Emerson	GA
Euharlee	GA
Evans	GA
Experiment	GA
Fair Oaks	GA
Fairburn	GA
Fairview	GA
Fayetteville	GA
Fitzgerald	GA
Flowery Branch	GA
Folkston	GA
Forest Park	GA
Forsyth	GA
Fort Gaines	GA
Fort Oglethorpe	GA
Fort Valley	GA
Gainesville	GA
Garden City	GA
Georgetown	GA
Glennville	GA
Gordon	GA
Grantville	GA
Gray	GA
Grayson	GA
Greensboro	GA
Gresham Park	GA
Griffin	GA
Grovetown	GA
Gumlog	GA
Guyton	GA
Hagan	GA
Hahira	GA
Hampton	GA
Hannahs Mill	GA
Hapeville	GA
Harlem	GA
Hartwell	GA
Hawkinsville	GA
Hazlehurst	GA
Helena	GA
Hephzibah	GA
Hinesville	GA
Hiram	GA
Hogansville	GA
Holly Springs	GA
Homer	GA
Homerville	GA
Hoschton	GA
Indian Springs	GA
Indian Springs	GA
Irondale	GA
Isle of Hope	GA
Ivey	GA
Jackson	GA
Jasper	GA
Jefferson	GA
Jefferson	GA
Jeffersonville	GA
Jesup	GA
Jonesboro	GA
Kennesaw	GA
Kingsland	GA
La Grange	GA
LaFayette	GA
Lake City	GA
Lakeland	GA
Lakeview	GA
Lakeview Estates	GA
Lavonia	GA
Lawrenceville	GA
Leesburg	GA
Lilburn	GA
Lincoln Park	GA
Lincolnton	GA
Lindale	GA
Lithia Springs	GA
Lithonia	GA
Locust Grove	GA
Loganville	GA
Lookout Mountain	GA
Louisville	GA
Lovejoy	GA
Ludowici	GA
Lula	GA
Lumber City	GA
Lumpkin	GA
Lyons	GA
Mableton	GA
Macon	GA
Madison	GA
Manchester	GA
Marietta	GA
Marshallville	GA
Martinez	GA
Maysville	GA
McCaysville	GA
McDonough	GA
McRae	GA
Meigs	GA
Metter	GA
Midway	GA
Milledgeville	GA
Millen	GA
Monroe	GA
Montezuma	GA
Montgomery	GA
Monticello	GA
Morgan	GA
Morrow	GA
Moultrie	GA
Mount Vernon	GA
Mount Zion	GA
Mount Zion	GA
Nahunta	GA
Nashville	GA
Newnan	GA
Nicholls	GA
Nicholson	GA
Norcross	GA
North Atlanta	GA
North Decatur	GA
North Druid Hills	GA
Oakwood	GA
Oakwood	GA
Ocilla	GA
Oglethorpe	GA
Omega	GA
Oxford	GA
Palmetto	GA
Panthersville	GA
Peachtree City	GA
Pearson	GA
Pelham	GA
Pembroke	GA
Perry	GA
Pine Mountain	GA
Pine Mountain	GA
Pooler	GA
Port Wentworth	GA
Porterdale	GA
Powder Springs	GA
Putney	GA
Quitman	GA
Raoul	GA
Redan	GA
Reed Creek	GA
Reidsville	GA
Reynolds	GA
Richland	GA
Richmond Hill	GA
Rincon	GA
Ringgold	GA
Riverdale	GA
Rochelle	GA
Rockmart	GA
Rome	GA
Roswell	GA
Rossville	GA
Royston	GA
Saint Marys	GA
Saint Simon Mills	GA
Saint Simons	GA
Sandersville	GA
Sandy Springs	GA
Sardis	GA
Sardis	GA
Savannah	GA
Scottdale	GA
Senoia	GA
Shannon	GA
Shannon	GA
Shellman	GA
Skidaway Island	GA
Smyrna	GA
Snellville	GA
Social Circle	GA
Soperton	GA
Sparks	GA
Sparks	GA
Sparta	GA
Springfield	GA
Statesboro	GA
Statham	GA
Stockbridge	GA
Stone Mountain	GA
Sugar Hill	GA
Summerville	GA
Sunnyside	GA
Suwanee	GA
Swainsboro	GA
Sylvania	GA
Sylvester	GA
Tallapoosa	GA
Temple	GA
Tennille	GA
Thomasville	GA
Thomaston	GA
Thomson	GA
Thunderbolt	GA
Tifton	GA
Toccoa	GA
Trenton	GA
Trion	GA
Tucker	GA
Tunnel Hill	GA
Twin City	GA
Tybee Island	GA
Tyrone	GA
Unadilla	GA
Union City	GA
Union Point	GA
Unionville	GA
Valdosta	GA
Varnell	GA
Vidalia	GA
Vienna	GA
Villa Rica	GA
Vinings	GA
Wadley	GA
Walnut Grove	GA
Walthourville	GA
Warner Robins	GA
Warrenton	GA
Washington	GA
Watkinsville	GA
Waycross	GA
Waynesboro	GA
West Point	GA
West Point	GA
Whitemarsh Island	GA
Willacoochee	GA
Wilmington Island	GA
Winder	GA
Winterville	GA
Woodbine	GA
Woodbury	GA
Woodstock	GA
Wrens	GA
Wrightsville	GA
Zebulon	GA
Albers	IL
Albion	IL
Alorton	IL
Altamont	IL
Alton	IL
Anna	IL
Arcola	IL
Arthur	IL
Ashland	IL
Assumption	IL
Athens	IL
Atwood	IL
Auburn	IL
Aviston	IL
Barry	IL
Beckemeyer	IL
Bement	IL
Benld	IL
Benton	IL
Bethalto	IL
Bethany	IL
Belleville	IL
Blue Mound	IL
Breese	IL
Bridgeport	IL
Brighton	IL
Brookport	IL
Bunker Hill	IL
Cahokia	IL
Cairo	IL
Cambria	IL
Carbondale	IL
Carlinville	IL
Carlyle	IL
Carmi	IL
Carrier Mills	IL
Carrollton	IL
Carterville	IL
Casey	IL
Caseyville	IL
Central City	IL
Centralia	IL
Centreville	IL
Cerro Gordo	IL
Charleston	IL
Chatham	IL
Chester	IL
Chrisman	IL
Christopher	IL
Cobden	IL
Collinsville	IL
Columbia	IL
Coulterville	IL
Crainville	IL
De Soto	IL
Decatur	IL
Divernon	IL
Du Quoin	IL
Dupo	IL
East Alton	IL
East Saint Louis	IL
Edinburg	IL
Edwardsville	IL
Effingham	IL
Eldorado	IL
Energy	IL
Fairfield	IL
Fairmont City	IL
Fairview Heights	IL
Flora	IL
Forsyth	IL
Freeburg	IL
Georgetown	IL
Germantown	IL
Gillespie	IL
Glen Carbon	IL
Girard	IL
Godfrey	IL
Grandview	IL
Granite City	IL
Grayville	IL
Greenfield	IL
Greenup	IL
Greenville	IL
Griggsville	IL
Harrisburg	IL
Harristown	IL
Hartford	IL
Herrin	IL
Highland	IL
Hillsboro	IL
Ina	IL
Jacksonville	IL
Jerome	IL
Jerseyville	IL
Johnston City	IL
Jonesboro	IL
Kincaid	IL
Lawrenceville	IL
Lebanon	IL
Leland Grove	IL
Litchfield	IL
Long Creek	IL
Louisville	IL
Lovington	IL
Macon	IL
Madison	IL
Marion	IL
Marissa	IL
Marshall	IL
Martinsville	IL
Maryville	IL
Mascoutah	IL
Mattoon	IL
McLeansboro	IL
Metropolis	IL
Millstadt	IL
Morrisonville	IL
Mounds	IL
Mount Carmel	IL
Mount Olive	IL
Mount Sterling	IL
Mount Vernon	IL
Mount Zion	IL
Moweaqua	IL
Murphysboro	IL
Nashville	IL
Neoga	IL
New Athens	IL
New Baden	IL
New Berlin	IL
Nokomis	IL
Norris City	IL
O'Fallon	IL
Oblong	IL
Odin	IL
Okawville	IL
Olney	IL
Palestine	IL
Pana	IL
Paris	IL
Pawnee	IL
Payson	IL
Pinckneyville	IL
Pittsfield	IL
Pleasant Hill	IL
Pontoon Beach	IL
Quincy	IL
Ramsey	IL
Red Bud	IL
Riverton	IL
Robinson	IL
Rochester	IL
Roodhouse	IL
Rosewood Heights	IL
Rosiclare	IL
Roxana	IL
Royalton	IL
Saint Elmo	IL
Salem	IL
Sandoval	IL
Sesser	IL
Shawneetown	IL
Shelbyville	IL
Sherman	IL
Shiloh	IL
Smithton	IL
South Jacksonville	IL
South Roxana	IL
Southern View	IL
Sparta	IL
Springfield	IL
Staunton	IL
Steeleville	IL
Sullivan	IL
Sumner	IL
Swansea	IL
Tamms	IL
Taylorville	IL
Teutopolis	IL
Toledo	IL
Tolono	IL
Trenton	IL
Troy	IL
Tuscola	IL
Upper Alton	IL
Vandalia	IL
Venice	IL
Vienna	IL
Villa Grove	IL
Virden	IL
Virginia	IL
Wamac	IL
Warrensburg	IL
Washington Park	IL
Waterloo	IL
Wayne City	IL
Waverly	IL
West Frankfort	IL
White Hall	IL
Williamsville	IL
Winchester	IL
Windsor	IL
Wood River	IL
Zeigler	IL
Austin	IN
Avon	IN
Bargersville	IN
Batesville	IN
Bedford	IN
Beech Grove	IN
Bicknell	IN
Bloomfield	IN
Bloomington	IN
Boonville	IN
Brazil	IN
Bright	IN
Brooklyn	IN
Brookville	IN
Brownsburg	IN
Brownstown	IN
Cambridge City	IN
Cannelton	IN
Carmel	IN
Cayuga	IN
Centerville	IN
Chandler	IN
Charlestown	IN
Clarksville	IN
Clay City	IN
Clermont	IN
Clinton	IN
Cloverdale	IN
Columbus	IN
Connersville	IN
Corydon	IN
Crothersville	IN
Cumberland	IN
Dale	IN
Danville	IN
Darmstadt	IN
Dillsboro	IN
Edinburgh	IN
Ellettsville	IN
Evansville	IN
Fairland	IN
Fairview Park	IN
Farmersburg	IN
Ferdinand	IN
Fishers	IN
Fort Branch	IN
Fortville	IN
French Lick	IN
Galena	IN
Geneva	IN
Georgetown	IN
Greencastle	IN
Greendale	IN
Greenfield	IN
Greensburg	IN
Greenwood	IN
Hagerstown	IN
Hanover	IN
Haubstadt	IN
Henryville	IN
Hidden Valley	IN
Highland	IN
Hope	IN
Huntingburg	IN
Indianapolis	IN
Ingalls	IN
Jasonville	IN
Jasper	IN
Jeffersonville	IN
Knightstown	IN
Ladoga	IN
Lawrence	IN
Lawrenceburg	IN
Liberty	IN
Linton	IN
Loogootee	IN
Lowell	IN
Madison	IN
Martinsville	IN
McCordsville	IN
Melody Hill	IN
Meridian Hills	IN
Middlebury	IN
Milan	IN
Mitchell	IN
Montezuma	IN
Mooresville	IN
Morristown	IN
Mount Vernon	IN
New Albany	IN
New Castle	IN
New Palestine	IN
New Whiteland	IN
Newburgh	IN
North Madison	IN
North Terre Haute	IN
North Vernon	IN
Oak Park	IN
Oakland City	IN
Odon	IN
Oolitic	IN
Orleans	IN
Osgood	IN
Owensville	IN
Paoli	IN
Pendleton	IN
Petersburg	IN
Pittsboro	IN
Plainfield	IN
Poseyville	IN
Princes Lakes	IN
Princeton	IN
Richmond	IN
Rising Sun	IN
Rockport	IN
Rockville	IN
Rockport	IN
Rushville	IN
Saint Paul	IN
Salem	IN
Santa Claus	IN
Scottsburg	IN
Seelyville	IN
Sellersburg	IN
Seymour	IN
Shelbyville	IN
Shelburn	IN
Southport	IN
Speedway	IN
Spencer	IN
Sullivan	IN
Tell City	IN
Terre Haute	IN
Versailles	IN
Vevay	IN
Vincennes	IN
Warren Park	IN
Washington	IN
Waterloo	IN
West Terre Haute	IN
Westport	IN
Whiteland	IN
Worthington	IN
Zionsville	IN
Abilene	KS
Altamont	KS
Andover	KS
Anthony	KS
Arkansas City	KS
Arma	KS
Atchison	KS
Auburn	KS
Augusta	KS
Baldwin City	KS
Basehor	KS
Baxter Springs	KS
Bellaire	KS
Belle Plaine	KS
Belleville	KS
Beloit	KS
Blue Rapids	KS
Bonner Springs	KS
Buhler	KS
Burlington	KS
Caldwell	KS
Caney	KS
Carbondale	KS
Chanute	KS
Chapman	KS
Cheney	KS
Cherryvale	KS
Chetopa	KS
Clay Center	KS
Clay Center	KS
Clearwater	KS
Coffeyville	KS
Columbus	KS
Colwich	KS
Concordia	KS
Conway Springs	KS
Council Grove	KS
De Soto	KS
Derby	KS
Douglass	KS
Edgerton	KS
Edwardsville	KS
El Dorado	KS
Ellinwood	KS
Ellis	KS
Ellsworth	KS
Elwood	KS
Emporia	KS
Erie	KS
Eureka	KS
Eudora	KS
Fairway	KS
Fort Scott	KS
Fredonia	KS
Galena	KS
Frontenac	KS
Gardner	KS
Garnett	KS
Girard	KS
Goddard	KS
Grandview Plaza	KS
Great Bend	KS
Greensburg	KS
Halstead	KS
Harper	KS
Haven	KS
Hays	KS
Haysville	KS
Herington	KS
Hesston	KS
Hiawatha	KS
Hill City	KS
Hillsboro	KS
Hoisington	KS
Holton	KS
Horton	KS
Humboldt	KS
Hutchinson	KS
Independence	KS
Inman	KS
Iola	KS
Junction City	KS
Kansas City	KS
Kechi	KS
Kingman	KS
Kinsley	KS
La Crosse	KS
La Cygne	KS
Lansing	KS
Larned	KS
Lawrence	KS
Leavenworth	KS
Leawood	KS
Lenexa	KS
Lincoln	KS
Lindsborg	KS
Louisburg	KS
Lyndon	KS
Lyons	KS
Maize	KS
Manhattan	KS
Marion	KS
Marysville	KS
McPherson	KS
Medicine Lodge	KS
Merriam	KS
Minneapolis	KS
Mission	KS
Mission Hills	KS
Moundridge	KS
Mulvane	KS
Neodesha	KS
Ness City	KS
Newton	KS
Nickerson	KS
North Newton	KS
Norton	KS
Ogden	KS
Olathe	KS
Osage City	KS
Osawatomie	KS
Osborne	KS
Oskaloosa	KS
Oswego	KS
Ottawa	KS
Overland Park	KS
Oxford	KS
Paola	KS
Park City	KS
Parsons	KS
Peabody	KS
Phillipsburg	KS
Pittsburg	KS
Plainville	KS
Pleasanton	KS
Prairie Village	KS
Pratt	KS
Roeland Park	KS
Rose Hill	KS
Russell	KS
Sabetha	KS
Saint John	KS
Saint Marys	KS
Saint Marys	KS
Salina	KS
Sedan	KS
Sedgwick	KS
Seneca	KS
Shawnee	KS
Silver Lake	KS
Smith Center	KS
Solomon	KS
South Hutchinson	KS
Spring Hill	KS
Stafford	KS
Sterling	KS
Tonganoxie	KS
Towanda	KS
Topeka	KS
Troy	KS
Valley Center	KS
Valley Falls	KS
Victoria	KS
WaKeeney	KS
Wamego	KS
Washington	KS
Wathena	KS
Wellington	KS
Wellsville	KS
Westwood	KS
Wichita	KS
Winfield	KS
Yates Center	KS
Albany	KY
Alexandria	KY
Anchorage	KY
Ashland	KY
Auburn	KY
Audubon Park	KY
Augusta	KY
Barbourmeade	KY
Barbourville	KY
Bardstown	KY
Beattyville	KY
Beaver Dam	KY
Beechwood Village	KY
Bellevue	KY
Benton	KY
Berea	KY
Bowling Green	KY
Brandenburg	KY
Breckinridge Center	KY
Brodhead	KY
Brooks	KY
Buckner	KY
Buechel	KY
Burkesville	KY
Burlington	KY
Cadiz	KY
Calvert City	KY
Campbellsville	KY
Carlisle	KY
Carrollton	KY
Catlettsburg	KY
Cave City	KY
Central City	KY
Claryville	KY
Clay	KY
Clay City	KY
Clinton	KY
Cloverport	KY
Cold Spring	KY
Columbia	KY
Corbin	KY
Covington	KY
Crescent Springs	KY
Crestview Hills	KY
Crestwood	KY
Crittenden	KY
Cumberland	KY
Cynthiana	KY
Danville	KY
Dawson Springs	KY
Dayton	KY
Douglass Hills	KY
Dry Ridge	KY
Earlington	KY
Eddyville	KY
Edgewood	KY
Edmonton	KY
Elizabethtown	KY
Elkhorn City	KY
Elkton	KY
Elsmere	KY
Eminence	KY
Erlanger	KY
Evarts	KY
Fairdale	KY
Falmouth	KY
Fern Creek	KY
Flatwoods	KY
Flemingsburg	KY
Florence	KY
Fort Mitchell	KY
Fort Thomas	KY
Fort Wright	KY
Frankfort	KY
Franklin	KY
Fulton	KY
Georgetown	KY
Glasgow	KY
Graymoor-Devondale	KY
Grayson	KY
Greensburg	KY
Greenup	KY
Greenville	KY
Guthrie	KY
Hardinsburg	KY
Harlan	KY
Harrodsburg	KY
Hartford	KY
Hazard	KY
Hebron Estates	KY
Henderson	KY
Hendron	KY
Hickman	KY
Highland Heights	KY
Highview	KY
Hillview	KY
Hodgenville	KY
Hopkinsville	KY
Horse Cave	KY
Hurstbourne Acres	KY
Hurstbourne	KY
Independence	KY
Indian Hills	KY
Indian Hills Cherokee Section	KY
Irvine	KY
Irvington	KY
Jackson	KY
Jackson	KY
Jamestown	KY
Jeffersontown	KY
Jeffersonville	KY
Jenkins	KY
Junction City	KY
La Center	KY
La Grange	KY
Lakeside Park	KY
Lancaster	KY
Lawrenceburg	KY
Lebanon	KY
Lebanon Junction	KY
Ledbetter	KY
Leitchfield	KY
Lewisport	KY
Lexington	KY
Lexington-Fayette	KY
Liberty	KY
Livermore	KY
London	KY
Louisa	KY
Louisville	KY
Ludlow	KY
Lyndon	KY
Madisonville	KY
Manchester	KY
Marion	KY
Masonville	KY
Massac	KY
Mayfield	KY
Maysville	KY
Middlesboro	KY
Middletown	KY
Midway	KY
Heritage Creek	KY
Monticello	KY
Monticello	KY
Morehead	KY
Morehead	KY
Morganfield	KY
Morgantown	KY
Mount Sterling	KY
Mount Vernon	KY
Mount Vernon	KY
Mount Washington	KY
Muldraugh	KY
Munfordville	KY
Murray	KY
Newburg	KY
Newport	KY
Nicholasville	KY
North Corbin	KY
Nortonville	KY
Oak Grove	KY
Oak Grove	KY
Oakbrook	KY
Okolona	KY
Olive Hill	KY
Orchard Grass Hills	KY
Owensboro	KY
Owenton	KY
Owingsville	KY
Paintsville	KY
Park Hills	KY
Paris	KY
Pewee Valley	KY
Pikeville	KY
Pine Knot	KY
Pineville	KY
Pioneer Village	KY
Pleasure Ridge Park	KY
Prestonsburg	KY
Princeton	KY
Prospect	KY
Providence	KY
Providence	KY
Raceland	KY
Radcliff	KY
Reidland	KY
Richmond	KY
Russell	KY
Russell Springs	KY
Russellville	KY
Saint Matthews	KY
Saint Regis Park	KY
Salyersville	KY
Scottsville	KY
Sebree	KY
Shelbyville	KY
Shepherdsville	KY
Shively	KY
Silver Grove	KY
Simpsonville	KY
Somerset	KY
South Shore	KY
Southgate	KY
Springfield	KY
Saint Dennis	KY
Stanford	KY
Stanton	KY
Stearns	KY
Sturgis	KY
Taylor Mill	KY
Taylorsville	KY
Tompkinsville	KY
Union	KY
Uniontown	KY
Van Lear	KY
Valley Station	KY
Vanceburg	KY
Versailles	KY
Villa Hills	KY
Vine Grove	KY
Walton	KY
Warsaw	KY
Watterson Park	KY
West Buechel	KY
West Liberty	KY
West Point	KY
Westwood	KY
Westwood	KY
Wheelwright	KY
Whitesburg	KY
Whitley City	KY
Wilder	KY
Williamsburg	KY
Williamstown	KY
Wilmore	KY
Winchester	KY
Windy Hills	KY
Woodlawn Park	KY
Worthington	KY
Worthington Hills	KY
Worthington	KY
Wurtland	KY
Abbeville	LA
Abita Springs	LA
Addis	LA
Albany	LA
Alexandria	LA
Ama	LA
Amelia	LA
Amite	LA
Arabi	LA
Arcadia	LA
Arnaudville	LA
Avondale	LA
Baker	LA
Baldwin	LA
Ball	LA
Barataria	LA
Basile	LA
Bastrop	LA
Baton Rouge	LA
Bayou Cane	LA
Bayou Gauche	LA
Bayou Vista	LA
Belle Chasse	LA
Belle Rose	LA
Benton	LA
Bernice	LA
Berwick	LA
Blanchard	LA
Bogalusa	LA
Bossier City	LA
Boutte	LA
Boyce	LA
Breaux Bridge	LA
Bridge City	LA
Broussard	LA
Brownfields	LA
Brusly	LA
Bunkie	LA
Cameron	LA
Campti	LA
Carencro	LA
Carlyss	LA
Carville	LA
Cecilia	LA
Chackbay	LA
Chalmette	LA
Charenton	LA
Chauvin	LA
Church Point	LA
Claiborne	LA
Clarks	LA
Clinton	LA
Colfax	LA
Cotton Valley	LA
Cottonport	LA
Covington	LA
Coushatta	LA
Crowley	LA
Cullen	LA
Cut Off	LA
DeQuincy	LA
DeRidder	LA
Delcambre	LA
Delhi	LA
Denham Springs	LA
Des Allemands	LA
Destrehan	LA
Donaldsonville	LA
Dulac	LA
Duson	LA
Eastwood	LA
Eden Isle	LA
Edgard	LA
Elmwood	LA
Elton	LA
Empire	LA
Epps	LA
Erath	LA
Estelle	LA
Eunice	LA
Farmerville	LA
Ferriday	LA
Franklin	LA
Franklinton	LA
French Settlement	LA
Galliano	LA
Gardere	LA
Garyville	LA
Gibsland	LA
Glenmora	LA
Golden Meadow	LA
Gonzales	LA
Grambling	LA
Gramercy	LA
Grand Coteau	LA
Grand Isle	LA
Gray	LA
Greenwood	LA
Greenwood	LA
Gretna	LA
Gueydan	LA
Hackberry	LA
Hahnville	LA
Hammond	LA
Harahan	LA
Harvey	LA
Haughton	LA
Haynesville	LA
Henderson	LA
Homer	LA
Houma	LA
Independence	LA
Inniswold	LA
Iota	LA
Iowa	LA
Jackson	LA
Jean Lafitte	LA
Jeanerette	LA
Jefferson	LA
Jena	LA
Jennings	LA
Jonesboro	LA
Jonesville	LA
Kaplan	LA
Kenner	LA
Kentwood	LA
Killian	LA
Kinder	LA
Krotz Springs	LA
Labadieville	LA
Lacombe	LA
Lafayette	LA
Lafitte	LA
Lake Arthur	LA
Lake Charles	LA
Lake Providence	LA
Laplace	LA
Larose	LA
Lecompte	LA
Leesville	LA
Leonville	LA
Livingston	LA
Livonia	LA
Lockport	LA
Logansport	LA
Luling	LA
Lydia	LA
Lutcher	LA
Mamou	LA
Mandeville	LA
Mansfield	LA
Mansura	LA
Many	LA
Maringouin	LA
Marksville	LA
Marrero	LA
Mathews	LA
Melville	LA
Meraux	LA
Merrydale	LA
Merryville	LA
Metairie	LA
Metairie Terrace	LA
Midway	LA
Minden	LA
Monroe	LA
Montegut	LA
Montegut	LA
Monticello	LA
Montz	LA
Morgan City	LA
Moss Bluff	LA
Natalbany	LA
Natchitoches	LA
New Iberia	LA
New Llano	LA
New Orleans	LA
New Roads	LA
New Sarpy	LA
Newellton	LA
Norco	LA
North Vacherie	LA
Oak Grove	LA
Oak Hills Place	LA
Oakdale	LA
Oakdale	LA
Oberlin	LA
Oil City	LA
Old Jefferson	LA
Olla	LA
Opelousas	LA
Paradis	LA
Patterson	LA
Pearl River	LA
Pierre Part	LA
Pine Prairie	LA
Pineville	LA
Plain Dealing	LA
Plaquemine	LA
Ponchatoula	LA
Port Allen	LA
Port Barre	LA
Port Sulphur	LA
Poydras	LA
Prien	LA
Raceland	LA
Rayne	LA
Rayville	LA
Reserve	LA
Richwood	LA
Ringgold	LA
River Ridge	LA
Roseland	LA
Rosepine	LA
Ruston	LA
Saint Francisville	LA
Saint Gabriel	LA
Saint Joseph	LA
Saint Martinville	LA
Saint Rose	LA
Schriever	LA
Scott	LA
Shenandoah	LA
Shreveport	LA
Sibley	LA
Simmesport	LA
Slaughter	LA
Slidell	LA
Sorrento	LA
South Vacherie	LA
Springhill	LA
Sterlington	LA
Stonewall	LA
Sulphur	LA
Sunset	LA
Supreme	LA
Swartz	LA
Tallulah	LA
Terrytown	LA
Thibodaux	LA
Timberlane	LA
Vidalia	LA
Village Saint George	LA
Ville Platte	LA
Vinton	LA
Violet	LA
Vivian	LA
Waggaman	LA
Walker	LA
Washington	LA
Welsh	LA
West Ferriday	LA
West Monroe	LA
Westlake	LA
Westwego	LA
Westminster	LA
White Castle	LA
Winnfield	LA
Winnsboro	LA
Wisner	LA
Woodmere	LA
Woodworth	LA
Zachary	LA
Youngsville	LA
Zwolle	LA
Aberdeen	MD
Accokeek	MD
Adelphi	MD
Algonquin	MD
Annapolis	MD
Arbutus	MD
Arden on the Severn	MD
Arnold	MD
Aspen Hill	MD
Baltimore	MD
Ballenger Creek	MD
Bel Air	MD
Beltsville	MD
Bennsville	MD
Berlin	MD
Berwyn Heights	MD
Bethesda	MD
Bladensburg	MD
Boonsboro	MD
Bowie	MD
Bowleys Quarters	MD
Braddock Heights	MD
Brandywine	MD
Brentwood	MD
Brooklyn Park	MD
Brookmont	MD
Brunswick	MD
Bryans Road	MD
Burtonsville	MD
Cabin John	MD
California	MD
Calverton	MD
Cambridge	MD
Camp Springs	MD
Cape Saint Claire	MD
Capitol Heights	MD
Carney	MD
Catonsville	MD
Cavetown	MD
Centreville	MD
Charlestown	MD
Charlestown	MD
Charlotte Hall	MD
Chesapeake Beach	MD
Chester	MD
Chestertown	MD
Cheverly	MD
Chevy Chase	MD
Chevy Chase Village	MD
Chillum	MD
Clarksburg	MD
Clover Hill	MD
Cloverly	MD
Clinton	MD
Cockeysville	MD
Colesville	MD
College Park	MD
Colmar Manor	MD
Columbia	MD
Coral Hills	MD
Cottage City	MD
Crofton	MD
Crisfield	MD
Crownsville	MD
Cumberland	MD
Damascus	MD
Darnestown	MD
Deale	MD
Delmar	MD
Denton	MD
District Heights	MD
Dundalk	MD
Dunkirk	MD
Dunkirk Town Center	MD
East Riverdale	MD
Easton	MD
Edgemere	MD
Edgewood	MD
Edmonston	MD
Eldersburg	MD
Elkton	MD
Elkridge	MD
Ellicott City	MD
Emmitsburg	MD
Essex	MD
Fairland	MD
Fairmount Heights	MD
Fallston	MD
Federalsburg	MD
Ferndale	MD
Forest Glen	MD
Forest Heights	MD
Forestville	MD
Fort George G Mead Junction	MD
Fort Washington	MD
Frederick	MD
Friendly	MD
Friendship Village	MD
Frostburg	MD
Fruitland	MD
Gaithersburg	MD
Garrison	MD
Germantown	MD
Glen Burnie	MD
Glenarden	MD
Glenn Dale	MD
Goddard	MD
Golden Beach	MD
Grasonville	MD
Green Haven	MD
Green Valley	MD
Greenbelt	MD
Greensboro	MD
Hagerstown	MD
Halfway	MD
Hampstead	MD
Hampton	MD
Hancock	MD
Havre de Grace	MD
Herald Harbor	MD
Highfield-Cascade	MD
Hillandale	MD
Hillcrest Heights	MD
Hillsmere Shores	MD
Hughesville	MD
Huntingtown	MD
Huntingtown Town Center	MD
Hurlock	MD
Hyattsville	MD
Indian Head	MD
Jarrettsville	MD
Joppatowne	MD
Kemp Mill	MD
Kensington	MD
Kettering	MD
Kingstown	MD
Kingsville	MD
La Plata	MD
La Vale	MD
Lake Arbor	MD
Lake Shore	MD
Landover Hills	MD
Langley Park	MD
Largo	MD
Laurel	MD
Leonardtown	MD
Lexington Park	MD
Linthicum	MD
Lochearn	MD
Lonaconing	MD
Londontowne	MD
Lusby	MD
Manchester	MD
Marlow Heights	MD
Marlton	MD
Maryland City	MD
Maugansville	MD
Mayo	MD
Mays Chapel	MD
Middle River	MD
Middletown	MD
Milford Mill	MD
Mitchellville	MD
Montgomery Village	MD
Morningside	MD
Mount Airy	MD
Mount Rainier	MD
Mountain Lake Park	MD
Myersville	MD
New Carrollton	MD
New Windsor	MD
North Beach	MD
North Bel Air	MD
North Bethesda	MD
North East	MD
North Kensington	MD
North Laurel	MD
North Potomac	MD
Oakland	MD
Ocean City	MD
Ocean Pines	MD
Odenton	MD
Olney	MD
Overlea	MD
Owings	MD
Owings Mills	MD
Parkville	MD
Parole	MD
Pasadena	MD
Perry Hall	MD
Perryman	MD
Perryville	MD
Pikesville	MD
Pittsville	MD
Pleasant Hills	MD
Pocomoke City	MD
Poolesville	MD
Potomac	MD
Potomac Heights	MD
Prince Frederick	MD
Princess Anne	MD
Pumphrey	MD
Randallstown	MD
Redland	MD
Reisterstown	MD
Ridgely	MD
Rising Sun	MD
Riva	MD
Riverdale Park	MD
Riverside	MD
Riverside	MD
Riviera Beach	MD
Robinwood	MD
Robinwood	MD
Rock Hall	MD
Rockville	MD
Rosaryville	MD
Rosedale	MD
Rossmoor	MD
Rossville	MD
Saint Charles	MD
Saint James	MD
Saint Michaels	MD
Salisbury	MD
Seat Pleasant	MD
Selby-on-the-Bay	MD
Severn	MD
Severna Park	MD
Shady Side	MD
Silver Spring	MD
Smithsburg	MD
Snow Hill	MD
Solomons	MD
Somerset	MD
South Bel Air	MD
South Gate	MD
South Kensington	MD
South Laurel	MD
Springdale	MD
Stevensville	MD
Sykesville	MD
Takoma Park	MD
Taneytown	MD
Temple Hills	MD
Thurmont	MD
Towson	MD
Trappe	MD
Travilah	MD
Union Bridge	MD
University Park	MD
Waldorf	MD
Walker Mill	MD
Walkersville	MD
West Elkridge	MD
West Laurel	MD
West Ocean City	MD
Westernport	MD
Westminster	MD
White Marsh	MD
White Oak	MD
Williamsport	MD
Woodlawn	MD
Woodlawn	MD
Woodmore	MD
Adrian	MO
Advance	MO
Affton	MO
Albany	MO
Anderson	MO
Appleton City	MO
Arnold	MO
Ash Grove	MO
Ashland	MO
Aurora	MO
Ava	MO
Ballwin	MO
Barnhart	MO
Battlefield	MO
Bel-Nor	MO
Bel-Ridge	MO
Belle	MO
Bellefontaine Neighbors	MO
Belton	MO
Berkeley	MO
Bernie	MO
Billings	MO
Bismarck	MO
Black Jack	MO
Bloomfield	MO
Blue Springs	MO
Bolivar	MO
Bonne Terre	MO
Boonville	MO
Bourbon	MO
Bowling Green	MO
Branson	MO
Breckenridge Hills	MO
Brentwood	MO
Bridgeton	MO
Brookfield	MO
Buckner	MO
Buffalo	MO
Butler	MO
Byrnes Mill	MO
Cabool	MO
California	MO
Calverton Park	MO
Camdenton	MO
Cameron	MO
Campbell	MO
Cape Girardeau	MO
Carl Junction	MO
Carrollton	MO
Carterville	MO
Carthage	MO
Caruthersville	MO
Cassville	MO
Castle Point	MO
Cedar Hill	MO
Centralia	MO
Chaffee	MO
Charlack	MO
Charleston	MO
Chesterfield	MO
Chillicothe	MO
Clarkson Valley	MO
Clarkton	MO
Claycomo	MO
Clayton	MO
Clever	MO
Clinton	MO
Cole Camp	MO
Columbia	MO
Concord	MO
Concordia	MO
Cool Valley	MO
Cottleville	MO
Country Club Hills	MO
Country Club Village	MO
Crane	MO
Crestwood	MO
Creve Coeur	MO
Crocker	MO
Crystal City	MO
Cuba	MO
Dardenne Prairie	MO
De Soto	MO
Dellwood	MO
Des Peres	MO
Desloge	MO
Dexter	MO
Dixon	MO
Doniphan	MO
Drexel	MO
Duenweg	MO
Duquesne	MO
East Independence	MO
East Prairie	MO
El Dorado Springs	MO
Eldon	MO
Ellington	MO
Ellisville	MO
Elsberry	MO
Elvins	MO
Esther	MO
Eureka	MO
Excelsior Springs	MO
Fair Grove	MO
Farmington	MO
Fayette	MO
Fenton	MO
Ferguson	MO
Festus	MO
Flat River	MO
Florissant	MO
Forsyth	MO
Four Seasons	MO
Fredericktown	MO
Frontenac	MO
Fulton	MO
Gallatin	MO
Garden City	MO
Gerald	MO
Gideon	MO
Gladstone	MO
Glasgow Village	MO
Glasgow	MO
Glendale	MO
Goodman	MO
Gower	MO
Grain Valley	MO
Granby	MO
Grandview	MO
Gray Summit	MO
Green Park	MO
Greenfield	MO
Greenwood	MO
Hamilton	MO
Hanley Hills	MO
Hannibal	MO
Harrisonville	MO
Hayti	MO
Hazelwood	MO
Herculaneum	MO
Hermann	MO
Higginsville	MO
High Ridge	MO
Hillsboro	MO
Hillsdale	MO
Holden	MO
Hollister	MO
Holts Summit	MO
Houston	MO
Huntsville	MO
Imperial	MO
Independence	MO
Ironton	MO
Jackson	MO
Jasper	MO
Jefferson City	MO
Jennings	MO
Joplin	MO
Kansas City	MO
Kearney	MO
Kennett	MO
Kimberling City	MO
Kirkwood	MO
Knob Noster	MO
La Monte	MO
Ladue	MO
Lake Lotawana	MO
Lake Ozark	MO
Lake Saint Louis	MO
Lake Winnebago	MO
Lakeshire	MO
Lamar	MO
Lathrop	MO
Lawson	MO
Leadwood	MO
Lebanon	MO
Lees Summit	MO
Lemay	MO
Lexington	MO
Liberty	MO
Licking	MO
Lilbourn	MO
Lincoln	MO
Louisiana	MO
Macon	MO
Malden	MO
Manchester	MO
Mansfield	MO
Maplewood	MO
Marble Hill	MO
Marceline	MO
Marionville	MO
Marlborough	MO
Marshall	MO
Marshfield	MO
Maryland Heights	MO
Maysville	MO
Mehlville	MO
Merriam Woods	MO
Mexico	MO
Miner	MO
Moberly	MO
Moline Acres	MO
Monett	MO
Monroe City	MO
Montgomery City	MO
Moscow Mills	MO
Mount Vernon	MO
Mountain Grove	MO
Mountain View	MO
Murphy	MO
Neosho	MO
Nevada	MO
New Haven	MO
New Madrid	MO
Nixa	MO
Noel	MO
Normandy	MO
North Kansas City	MO
Northwoods	MO
Norwood Court	MO
O'Fallon	MO
Oak Grove	MO
Oakland	MO
Oakville	MO
Odessa	MO
Olivette	MO
Oran	MO
Oronogo	MO
Osage Beach	MO
Overland	MO
Owensville	MO
Ozark	MO
Pacific	MO
Pagedale	MO
Palmyra	MO
Paris	MO
Park Hills	MO
Parkville	MO
Pasadena Hills	MO
Peculiar	MO
Perryville	MO
Pevely	MO
Piedmont	MO
Pierce City	MO
Pine Lawn	MO
Platte City	MO
Plattsburg	MO
Pleasant Hill	MO
Pleasant Valley	MO
Poplar Bluff	MO
Portageville	MO
Potosi	MO
Purdy	MO
Puxico	MO
Raymore	MO
Raytown	MO
Republic	MO
Rich Hill	MO
Richland	MO
Richmond	MO
Richmond Heights	MO
Riverside	MO
Riverside	MO
Riverview	MO
Riverview	MO
Rock Hill	MO
Rogersville	MO
Rolla	MO
Saint Ann	MO
Saint Charles	MO
Saint Clair	MO
Saint George	MO
Saint James	MO
Saint John	MO
Saint Johns	MO
Saint Joseph	MO
Saint Louis	MO
Saint Martins	MO
Saint Paul	MO
Saint Peters	MO
Saint Robert	MO
Sainte Genevieve	MO
Salem	MO
Salisbury	MO
Sappington	MO
Sarcoxie	MO
Savannah	MO
Scott City	MO
Sedalia	MO
Senath	MO
Seneca	MO
Seymour	MO
Shelbina	MO
Shell Knob	MO
Shrewsbury	MO
Sikeston	MO
Slater	MO
Smithville	MO
Spanish Lake	MO
Sparta	MO
Springfield	MO
Steele	MO
Steelville	MO
Stockton	MO
Stover	MO
Strafford	MO
Sugar Creek	MO
Sullivan	MO
Sunset Hills	MO
Sweet Springs	MO
Thayer	MO
Tipton	MO
Town and Country	MO
Troy	MO
Union	MO
University City	MO
Valley Park	MO
Vandalia	MO
Velda Village	MO
Velda Village Hills	MO
Versailles	MO
Vinita Park	MO
Warrensburg	MO
Warrenton	MO
Warsaw	MO
Warson Woods	MO
Washington	MO
Waynesville	MO
Weatherby Lake	MO
Webb City	MO
Webster Groves	MO
Weldon Spring	MO
Wellston	MO
Wellsville	MO
Wentzville	MO
West Plains	MO
Weston	MO
Wildwood	MO
Willard	MO
Willow Springs	MO
Winchester	MO
Windsor	MO
Winona	MO
Woodson Terrace	MO
Wright City	MO
Aberdeen	MS
Ackerman	MS
Amory	MS
Baldwyn	MS
Batesville	MS
Bay Saint Louis	MS
Bay Springs	MS
Belmont	MS
Belmont	MS
Belzoni	MS
Biloxi	MS
Booneville	MS
Brandon	MS
Brookhaven	MS
Brooksville	MS
Bruce	MS
Bude	MS
Burnsville	MS
Byram	MS
Calhoun City	MS
Canton	MS
Carthage	MS
Centreville	MS
Charleston	MS
Clarksdale	MS
Cleveland	MS
Clinton	MS
Coldwater	MS
Coldwater	MS
Collins	MS
Collinsville	MS
Columbus	MS
Columbia	MS
Como	MS
Conehatta	MS
Corinth	MS
Crystal Springs	MS
D'Iberville	MS
Decatur	MS
Diamondhead	MS
Drew	MS
Duck Hill	MS
Durant	MS
Ecru	MS
Edwards	MS
Ellisville	MS
Escatawpa	MS
Eupora	MS
Farmington	MS
Fayette	MS
Flora	MS
Florence	MS
Flowood	MS
Forest	MS
Friars Point	MS
Fulton	MS
Gautier	MS
Gloster	MS
Goodman	MS
Greenville	MS
Greenwood	MS
Grenada	MS
Gulf Hills	MS
Gulf Park Estates	MS
Gulfport	MS
Guntown	MS
Hattiesburg	MS
Hazlehurst	MS
Hernando	MS
Hickory Hills	MS
Hollandale	MS
Holly Springs	MS
Holly Springs	MS
Horn Lake	MS
Houston	MS
Hurley	MS
Indianola	MS
Inverness	MS
Itta Bena	MS
Iuka	MS
Jackson	MS
Jonestown	MS
Kiln	MS
Kosciusko	MS
Lambert	MS
Latimer	MS
Laurel	MS
Leland	MS
Lexington	MS
Long Beach	MS
Louisville	MS
Lucedale	MS
Lumberton	MS
Lyman	MS
Lynchburg	MS
Lynchburg	MS
Macon	MS
Madison	MS
Magee	MS
Magnolia	MS
Mantachie	MS
Marion	MS
Marks	MS
McComb	MS
Mendenhall	MS
Meridian	MS
Metcalfe	MS
Monticello	MS
Moorhead	MS
Morton	MS
Moss Point	MS
Mound Bayou	MS
Natchez	MS
Nellieburg	MS
Nettleton	MS
New Albany	MS
New Hope	MS
Newton	MS
North Tunica	MS
Ocean Springs	MS
Okolona	MS
Olive Branch	MS
Oxford	MS
Pascagoula	MS
Pass Christian	MS
Pearl	MS
Pearl River	MS
Pearlington	MS
Pelahatchie	MS
Petal	MS
Philadelphia	MS
Picayune	MS
Pickens	MS
Plantersville	MS
Pontotoc	MS
Poplarville	MS
Port Gibson	MS
Prentiss	MS
Purvis	MS
Quitman	MS
Raleigh	MS
Raymond	MS
Richland	MS
Richton	MS
Ridgeland	MS
Ripley	MS
Rolling Fork	MS
Ruleville	MS
Saltillo	MS
Sardis	MS
Saucier	MS
Senatobia	MS
Shannon	MS
Shelby	MS
Southaven	MS
Saint Martin	MS
Starkville	MS
Stonewall	MS
Summit	MS
Sumrall	MS
Taylorsville	MS
Tchula	MS
Tunica	MS
Tupelo	MS
Tutwiler	MS
Tylertown	MS
Union	MS
Vancleave	MS
Vardaman	MS
Verona	MS
Vicksburg	MS
Walnut Grove	MS
Water Valley	MS
Waveland	MS
Waynesboro	MS
Wesson	MS
West Gulfport	MS
West Hattiesburg	MS
West Point	MS
Wiggins	MS
Winona	MS
Woodville	MS
Yazoo City	MS
Aberdeen	NC
Ahoskie	NC
Albemarle	NC
Andrews	NC
Angier	NC
Apex	NC
Archdale	NC
Asheboro	NC
Asheville	NC
Atlantic Beach	NC
Avery Creek	NC
Ayden	NC
Badin	NC
Balfour	NC
Barker Heights	NC
Bayshore	NC
Beaufort	NC
Belhaven	NC
Belmont	NC
Belwood	NC
Benson	NC
Bent Creek	NC
Bermuda Run	NC
Bessemer City	NC
Bethel	NC
Bethlehem	NC
Beulaville	NC
Biltmore Forest	NC
Biscoe	NC
Black Mountain	NC
Bladenboro	NC
Blowing Rock	NC
Boiling Spring Lakes	NC
Boiling Springs	NC
Boone	NC
Boonville	NC
Brevard	NC
Brices Creek	NC
Brogden	NC
Bryson City	NC
Buies Creek	NC
Burgaw	NC
Burlington	NC
Burnsville	NC
Burnsville	NC
Butner	NC
Cajahs Mountain	NC
Canton	NC
Cape Carteret	NC
Carolina Beach	NC
Carolina Shores	NC
Carrboro	NC
Carthage	NC
Cary	NC
Castle Hayne	NC
Chadbourn	NC
Chapel Hill	NC
Charlotte	NC
Cherokee	NC
Cherryville	NC
China Grove	NC
Claremont	NC
Clayton	NC
Clemmons	NC
Clinton	NC
Clyde	NC
Coats	NC
Concord	NC
Connelly Springs	NC
Conover	NC
Cornelius	NC
Cramerton	NC
Creedmoor	NC
Cricket	NC
Cullowhee	NC
Dallas	NC
Davidson	NC
Denton	NC
Dobson	NC
Drexel	NC
Dunn	NC
Durham	NC
East Flat Rock	NC
East Rockingham	NC
East Spencer	NC
Eastover	NC
Eden	NC
Edenton	NC
Elizabeth City	NC
Elizabethtown	NC
Elkin	NC
Elm City	NC
Elon	NC
Elroy	NC
Emerald Isle	NC
Enfield	NC
Enochville	NC
Erwin	NC
Etowah	NC
Fair Bluff	NC
Fairfield Harbour	NC
Fairmont	NC
Fairplains	NC
Fairview	NC
Farmville	NC
Farmville	NC
Fayetteville	NC
Flat Rock	NC
Flat Rock	NC
Fletcher	NC
Forest City	NC
Forest Oaks	NC
Four Oaks	NC
Franklin	NC
Franklin	NC
Franklinton	NC
Franklinville	NC
Fremont	NC
Fuquay-Varina	NC
Gamewell	NC
Garner	NC
Garysburg	NC
Gastonia	NC
Gibsonville	NC
Glen Alpine	NC
Glen Raven	NC
Goldsboro	NC
Graham	NC
Granite Falls	NC
Granite Quarry	NC
Green Level	NC
Green Level	NC
Greensboro	NC
Greenville	NC
Grifton	NC
Half Moon	NC
Hamlet	NC
Harkers Island	NC
Harrisburg	NC
Havelock	NC
Haw River	NC
Hays	NC
Hazelwood	NC
Hemby Bridge	NC
Henderson	NC
Hendersonville	NC
Hertford	NC
Hickory	NC
High Point	NC
Hildebran	NC
Hillsborough	NC
Holly Springs	NC
Hope Mills	NC
Hudson	NC
Huntersville	NC
Icard	NC
Indian Trail	NC
Jacksonville	NC
James City	NC
Jamestown	NC
Jefferson	NC
Jonesville	NC
Kannapolis	NC
Kenly	NC
Kernersville	NC
Kill Devil Hills	NC
Kings Grant	NC
Kings Mountain	NC
Kinston	NC
Kitty Hawk	NC
Knightdale	NC
Kure Beach	NC
La Grange	NC
Lake Junaluska	NC
Lake Norman of Catawba	NC
Lake Park	NC
Lake Waccamaw	NC
Landis	NC
Laurel Park	NC
Laurinburg	NC
Leland	NC
Lenoir	NC
Lewisville	NC
Lexington	NC
Liberty	NC
Lillington	NC
Lincolnton	NC
Locust	NC
Long Beach	NC
Longview	NC
Louisburg	NC
Lowell	NC
Lowesville	NC
Lumberton	NC
Madison	NC
Maiden	NC
Manteo	NC
Mar-Mac	NC
Marion	NC
Mars Hill	NC
Marshville	NC
Marvin	NC
Masonboro	NC
Matthews	NC
Maxton	NC
Mayodan	NC
McLeansville	NC
Mebane	NC
Midland	NC
Millers Creek	NC
Mineral Springs	NC
Mint Hill	NC
Mocksville	NC
Monroe	NC
Mooresville	NC
Moravian Falls	NC
Morehead City	NC
Morganton	NC
Morrisville	NC
Mount Airy	NC
Mount Gilead	NC
Mount Holly	NC
Mount Olive	NC
Mount Pleasant	NC
Mountain Home	NC
Mountain View	NC
Mulberry	NC
Murfreesboro	NC
Murphy	NC
Murraysville	NC
Myrtle Grove	NC
Nags Head	NC
Nashville	NC
Navassa	NC
Neuse Forest	NC
New Bern	NC
Newport	NC
Newton	NC
Norlina	NC
North Wilkesboro	NC
Northlakes	NC
Norwood	NC
Oak Island	NC
Oak Ridge	NC
Oakboro	NC
Ogden	NC
Oxford	NC
Pembroke	NC
Pilot Mountain	NC
Pine Knoll Shores	NC
Pine Level	NC
Pinebluff	NC
Pinehurst	NC
Pinetops	NC
Pineville	NC
Piney Green	NC
Pittsboro	NC
Plain View	NC
Pleasant Garden	NC
Pleasant Hill	NC
Pleasant Hill	NC
Plymouth	NC
Polkton	NC
Princeton	NC
Princeville	NC
Pumpkin Center	NC
Pumpkin Center	NC
Raeford	NC
Raleigh	NC
Ramseur	NC
Randleman	NC
Ranlo	NC
Red Oak	NC
Red Springs	NC
Reidsville	NC
Rhodhiss	NC
Rich Square	NC
River Bend	NC
River Road	NC
Roanoke Rapids	NC
Robbins	NC
Robersonville	NC
Rockfish	NC
Rockingham	NC
Rockwell	NC
Rocky Mount	NC
Rose Hill	NC
Roseboro	NC
Rowland	NC
Roxboro	NC
Royal Pines	NC
Rural Hall	NC
Rutherford College	NC
Rutherfordton	NC
Saint Pauls	NC
Salem	NC
Salisbury	NC
Sanford	NC
Sawmills	NC
Saxapahaw	NC
Scotland Neck	NC
Sea Breeze	NC
Seagate	NC
Selma	NC
Seven Lakes	NC
Shallotte	NC
Sharpsburg	NC
Shelby	NC
Sherrills Ford	NC
Siler City	NC
Silver City	NC
Silver Lake	NC
Skippers Corner	NC
Smithfield	NC
Sneads Ferry	NC
Snow Hill	NC
South Gastonia	NC
South Henderson	NC
South Rosemary	NC
South Weldon	NC
Southern Pines	NC
Southern Shores	NC
Southport	NC
Sparta	NC
Spencer	NC
Spindale	NC
Spring Hope	NC
Spring Lake	NC
Spruce Pine	NC
Saint Stephens	NC
Stallings	NC
Stanfield	NC
Stanley	NC
Statesville	NC
Stokesdale	NC
Stony Point	NC
Summerfield	NC
Summerfield	NC
Sunset Beach	NC
Surf City	NC
Swannanoa	NC
Swansboro	NC
Sylva	NC
Tabor City	NC
Tarboro	NC
Taylorsville	NC
Thomasville	NC
Toast	NC
Tobaccoville	NC
Trent Woods	NC
Trinity	NC
Troutman	NC
Troy	NC
Tryon	NC
Tryon	NC
Unionville	NC
Valdese	NC
Valley Hill	NC
Vander	NC
Wadesboro	NC
Wake Forest	NC
Walkertown	NC
Walkertown	NC
Wallace	NC
Walnut Cove	NC
Wanchese	NC
Warsaw	NC
Washington	NC
Waxhaw	NC
Waynesville	NC
Weaverville	NC
Weddington	NC
Welcome	NC
Weldon	NC
Wentworth	NC
Wesley Chapel	NC
Wendell	NC
West Canton	NC
West Jefferson	NC
West Marion	NC
West Raleigh	NC
Westport	NC
Whispering Pines	NC
White Plains	NC
White Plains	NC
Whiteville	NC
Wilkesboro	NC
Williamston	NC
Wilmington	NC
Wilson	NC
Wilsons Mills	NC
Windsor	NC
Windsor	NC
Wingate	NC
Winston-Salem	NC
Winterville	NC
Woodfin	NC
Woodlawn	NC
Wrightsboro	NC
Wrightsville Beach	NC
Yadkinville	NC
Yanceyville	NC
Zebulon	NC
Absecon	NJ
Alloway	NJ
Ashland	NJ
Atlantic City	NJ
Audubon	NJ
Audubon Park	NJ
Avalon	NJ
Barnegat	NJ
Barrington	NJ
Beach Haven	NJ
Beach Haven West	NJ
Beachwood	NJ
Beckett	NJ
Bellmawr	NJ
Berlin	NJ
Blackwood	NJ
Brigantine	NJ
Bridgeton	NJ
Brooklawn	NJ
Browns Mills	NJ
Buena	NJ
Camden	NJ
Cape May Court House	NJ
Cape May	NJ
Carneys Point	NJ
Cedar Glen Lakes	NJ
Cherry Hill	NJ
Cherry Hill Mall	NJ
Chesilhurst	NJ
Cinnaminson	NJ
Clayton	NJ
Clementon	NJ
Collings Lakes	NJ
Collingswood	NJ
Country Lake Estates	NJ
Crestwood Village	NJ
Dover Beaches North	NJ
Dover Beaches South	NJ
Echelon	NJ
Egg Harbor City	NJ
Elmer	NJ
Erma	NJ
Estell Manor	NJ
Fairton	NJ
Folsom	NJ
Forked River	NJ
Gibbsboro	NJ
Gibbstown	NJ
Glassboro	NJ
Glendora	NJ
Gloucester City	NJ
Golden Triangle	NJ
Greentree	NJ
Haddon Heights	NJ
Haddonfield	NJ
Hammonton	NJ
Hi-Nella	NJ
Holiday Heights	NJ
Island Heights	NJ
Laurel Lake	NJ
Lavallette	NJ
Lawnside	NJ
Laurel Springs	NJ
Leisuretowne	NJ
Lindenwold	NJ
Linwood	NJ
Longport	NJ
Magnolia	NJ
Magnolia	NJ
Manahawkin	NJ
Maple Shade	NJ
Margate City	NJ
Marlton	NJ
Mays Landing	NJ
Medford Lakes	NJ
Millville	NJ
Mount Ephraim	NJ
Mount Holly	NJ
Mullica Hill	NJ
Mystic Islands	NJ
National Park	NJ
Newfield	NJ
North Beach Haven	NJ
North Cape May	NJ
North Wildwood	NJ
Northfield	NJ
Oaklyn	NJ
Ocean Acres	NJ
Ocean City	NJ
Ocean Gate	NJ
Olivet	NJ
Paulsboro	NJ
Pemberton	NJ
Pemberton Heights	NJ
Penns Grove	NJ
Pennsauken	NJ
Pennsville	NJ
Pine Beach	NJ
Pine Hill	NJ
Pine Ridge at Crestwood	NJ
Pitman	NJ
Pleasantville	NJ
Pomona	NJ
Port Norris	NJ
Port Republic	NJ
Presidential Lakes Estates	NJ
Ramblewood	NJ
Rio Grande	NJ
Rosenhayn	NJ
Salem	NJ
Runnemede	NJ
Sea Isle City	NJ
Seabrook Farms	NJ
Seaside Heights	NJ
Seaside Park	NJ
Ship Bottom	NJ
Silver Ridge	NJ
Somerdale	NJ
Somers Point	NJ
South Toms River	NJ
South Vineland	NJ
Springdale	NJ
Stone Harbor	NJ
Stratford	NJ
Surf City	NJ
Swedesboro	NJ
Toms River	NJ
Tuckerton	NJ
Turnersville	NJ
Ventnor City	NJ
Victory Lakes	NJ
Villas	NJ
Vineland	NJ
Waretown	NJ
Wenonah	NJ
West Cape May	NJ
Westville	NJ
Wildwood	NJ
Wildwood Crest	NJ
Williamstown	NJ
Wood-Lynne	NJ
Woodbine	NJ
Woodbury	NJ
Woodbury Heights	NJ
Woodstown	NJ
Aberdeen	OH
Amberley	OH
Amelia	OH
Arcanum	OH
Ashville	OH
Athens	OH
Bainbridge	OH
Baltimore	OH
Barnesville	OH
Batavia	OH
Beavercreek	OH
Beckett Ridge	OH
Bellbrook	OH
Belpre	OH
Bethel	OH
Bethel	OH
Beverly	OH
Bexley	OH
Blacklick Estates	OH
Blanchester	OH
Blue Ash	OH
Brookville	OH
Buckeye Lake	OH
Burlington	OH
Byesville	OH
Caldwell	OH
Camden	OH
Canal Winchester	OH
Carlisle	OH
Cedarville	OH
Centerville	OH
Chauncey	OH
Cherry Grove	OH
Cheviot	OH
Choctaw Lake	OH
Cincinnati	OH
Circleville	OH
Clayton	OH
Cleves	OH
Coal Grove	OH
Columbus	OH
Covedale	OH
Crooksville	OH
Crystal Lakes	OH
Day Heights	OH
Dayton	OH
Deer Park	OH
Dent	OH
Devola	OH
Dillonvale	OH
Drexel	OH
Dry Run	OH
Eaton	OH
Elmwood Place	OH
Englewood	OH
Enon	OH
Evendale	OH
Fairborn	OH
Fairfax	OH
Fairfield	OH
Fairfield Beach	OH
Finneytown	OH
Five Points	OH
Forest Park	OH
Forestville	OH
Fort McKinley	OH
Frankfort	OH
Franklin	OH
Franklin Furnace	OH
Fruit Hill	OH
Gallipolis	OH
Geneva	OH
Georgetown	OH
Germantown	OH
Glendale	OH
Glouster	OH
Golf Manor	OH
Grandview	OH
Grandview Heights	OH
Green Meadows	OH
Greenfield	OH
Greenhills	OH
Groesbeck	OH
Grove City	OH
Groveport	OH
Hamilton	OH
Harbor Hills	OH
Harrison	OH
Hebron	OH
Hillsboro	OH
Holiday Valley	OH
Huber Heights	OH
Hunter	OH
Ironton	OH
Jackson	OH
Jamestown	OH
Jeffersonville	OH
Kenwood	OH
Kettering	OH
Lake Darby	OH
Lancaster	OH
Landen	OH
Lebanon	OH
Leesburg	OH
Lewisburg	OH
Lincoln Heights	OH
Lincoln Village	OH
Lisbon	OH
Lockland	OH
Logan	OH
London	OH
Loveland	OH
Loveland Park	OH
Lucasville	OH
Lynchburg	OH
Madeira	OH
Maineville	OH
Manchester	OH
Mariemont	OH
Marietta	OH
Mason	OH
Mayfield	OH
McArthur	OH
McConnelsville	OH
Miamisburg	OH
Middleport	OH
Middletown	OH
Milford	OH
Monroe	OH
Montgomery	OH
Moraine	OH
Morrow	OH
Mount Carmel	OH
Mount Healthy	OH
Mount Healthy Heights	OH
Mount Orab	OH
Mount Repose	OH
Mount Sterling	OH
Mulberry	OH
Nelsonville	OH
New Boston	OH
New Carlisle	OH
New Concord	OH
New Lebanon	OH
New Lexington	OH
New Matamoras	OH
New Miami	OH
New Paris	OH
New Richmond	OH
New Vienna	OH
Newtown	OH
North College Hill	OH
North Fork Village	OH
North Zanesville	OH
Northbrook	OH
Northgate	OH
Northridge	OH
Northridge	OH
Norwood	OH
Oak Hill	OH
Oakwood	OH
Obetz	OH
Oxford	OH
Park Layne	OH
Pataskala	OH
Peebles	OH
Pickerington	OH
Piketon	OH
Pleasant Grove	OH
Pleasant Run	OH
Pleasant Run Farm	OH
Pomeroy	OH
Portsmouth	OH
Powhatan Point	OH
Reading	OH
Reynoldsburg	OH
Ripley	OH
Riverside	OH
Rosemount	OH
Ross	OH
Roseville	OH
Sabina	OH
Saint Bernard	OH
Seaman	OH
Shadyside	OH
Sharonville	OH
Shawnee Hills	OH
Shiloh	OH
Silverton	OH
Somerset	OH
South Bloomfield	OH
South Charleston	OH
South Lebanon	OH
South Point	OH
South Zanesville	OH
Springboro	OH
Springdale	OH
Springfield	OH
Summerside	OH
Terrace Park	OH
The Plains	OH
The Village of Indian Hill	OH
Tipp City	OH
Trenton	OH
Trotwood	OH
Union	OH
Upper Arlington	OH
Vandalia	OH
Washington Court House	OH
Waverly	OH
Waynesville	OH
Wellston	OH
West Alexandria	OH
West Carrollton City	OH
West Jefferson	OH
West Milton	OH
West Portsmouth	OH
West Union	OH
Wetherington	OH
Wheelersburg	OH
White Oak	OH
Whitehall	OH
Wilberforce	OH
Williamsburg	OH
Williamsport	OH
Wilmington	OH
Winchester	OH
Withamsville	OH
Woodlawn	OH
Woodsfield	OH
Wyoming	OH
Xenia	OH
Yellow Springs	OH
Zanesville	OH
Ada	OK
Afton	OK
Altus	OK
Alva	OK
Anadarko	OK
Antlers	OK
Apache	OK
Ardmore	OK
Arkoma	OK
Atoka	OK
Barnsdall	OK
Bartlesville	OK
Beggs	OK
Bethany	OK
Bethel Acres	OK
Bixby	OK
Blackwell	OK
Blanchard	OK
Boley	OK
Bray	OK
Bristow	OK
Broken Arrow	OK
Broken Bow	OK
Buffalo	OK
Burns Flat	OK
Bushyhead	OK
Byng	OK
Cache	OK
Calera	OK
Carnegie	OK
Catoosa	OK
Chandler	OK
Checotah	OK
Chelsea	OK
Cherokee	OK
Cherry Tree	OK
Chickasha	OK
Choctaw	OK
Chouteau	OK
Claremore	OK
Cleora	OK
Cleveland	OK
Clinton	OK
Colbert	OK
Collinsville	OK
Comanche	OK
Commerce	OK
Copeland	OK
Cordell	OK
Coweta	OK
Crescent	OK
Cushing	OK
Cyril	OK
Davis	OK
Del City	OK
Dewey	OK
Dickson	OK
Drumright	OK
Duncan	OK
Durant	OK
Edmond	OK
El Reno	OK
Eldon	OK
Elgin	OK
Elk City	OK
Enid	OK
Eufaula	OK
Fairfax	OK
Fairland	OK
Fairview	OK
Fletcher	OK
Forest Park	OK
Fort Gibson	OK
Frederick	OK
Geary	OK
Glenpool	OK
Goldsby	OK
Grandfield	OK
Granite	OK
Grove	OK
Guthrie	OK
Hall Park	OK
Harrah	OK
Hartshorne	OK
Haskell	OK
Healdton	OK
Heavener	OK
Helena	OK
Hennessey	OK
Henryetta	OK
Hinton	OK
Hobart	OK
Holdenville	OK
Hollis	OK
Hominy	OK
Hugo	OK
Hydro	OK
Idabel	OK
Inola	OK
Jay	OK
Jenks	OK
Jones	OK
Justice	OK
Kiefer	OK
Kingfisher	OK
Kingston	OK
Konawa	OK
Krebs	OK
Langston	OK
Laverne	OK
Lawton	OK
Lexington	OK
Lindsay	OK
Locust Grove	OK
Lone Grove	OK
Longtown	OK
Madill	OK
Mangum	OK
Mannford	OK
Marietta	OK
Marlow	OK
Marlow	OK
Maud	OK
Maysville	OK
McAlester	OK
McCord	OK
McLoud	OK
Medford	OK
Meridian	OK
Meridian	OK
Miami	OK
Midwest City	OK
Minco	OK
Moore	OK
Mooreland	OK
Morris	OK
Mounds	OK
Muldrow	OK
Muskogee	OK
Mustang	OK
Newcastle	OK
Newkirk	OK
Nichols Hills	OK
Nicoma Park	OK
Ninnekah	OK
Noble	OK
Norman	OK
Nowata	OK
Oakhurst	OK
Oilton	OK
Okarche	OK
Okeene	OK
Okemah	OK
Oklahoma City	OK
Okmulgee	OK
Oologah	OK
Owasso	OK
Panama	OK
Park Hill	OK
Pawhuska	OK
Pawnee	OK
Pauls Valley	OK
Perkins	OK
Perry	OK
Picher	OK
Piedmont	OK
Pink	OK
Pocola	OK
Ponca City	OK
Poteau	OK
Prague	OK
Pryor	OK
Purcell	OK
Quinton	OK
Ringling	OK
Roland	OK
Rush Springs	OK
Salina	OK
Sallisaw	OK
Sand Springs	OK
Sapulpa	OK
Sayre	OK
Seminole	OK
Shattuck	OK
Shawnee	OK
Skiatook	OK
Slaughterville	OK
Snyder	OK
Spencer	OK
Sperry	OK
Spiro	OK
Stigler	OK
Stillwater	OK
Stilwell	OK
Stratford	OK
Stroud	OK
Sulphur	OK
Tahlequah	OK
Talihina	OK
Tecumseh	OK
Temple	OK
Texanna	OK
The Village	OK
Thomas	OK
Tishomingo	OK
Tonkawa	OK
Tulsa	OK
Turley	OK
Tuttle	OK
Union City	OK
Verdigris	OK
Vian	OK
Vinita	OK
Wagoner	OK
Walters	OK
Warr Acres	OK
Warner	OK
Watonga	OK
Waukomis	OK
Waurika	OK
Weatherford	OK
Westville	OK
Wetumka	OK
Wewoka	OK
Wilburton	OK
Wilson	OK
Wilson	OK
Wister	OK
Woodward	OK
Wynnewood	OK
Yale	OK
Yukon	OK
Aldan	PA
Atglen	PA
Avondale	PA
Berlin	PA
Biglerville	PA
Bonneauville	PA
Boothwyn	PA
Brookhaven	PA
Broomall	PA
Carroll Valley	PA
Chambersburg	PA
Chester	PA
Chester Heights	PA
Christiana	PA
Clifton Heights	PA
Coatesville	PA
Collingdale	PA
Colwyn	PA
Dallastown	PA
Darby	PA
Drexel Hill	PA
Dunbar	PA
East Berlin	PA
East Lansdowne	PA
East Uniontown	PA
East York	PA
Eddystone	PA
Fairchance	PA
Fairdale	PA
Fayetteville	PA
Folsom	PA
Folcroft	PA
Gap	PA
Gettysburg	PA
Glen Rock	PA
Glenolden	PA
Grantley	PA
Greencastle	PA
Guilford	PA
Hanover	PA
Hopwood	PA
Jacobus	PA
Kennett Square	PA
Lake Heritage	PA
Lake Meade	PA
Lansdowne	PA
Lima	PA
Linwood	PA
Littlestown	PA
Loganville	PA
Luzerne	PA
Marcus Hook	PA
Masontown	PA
McConnellsburg	PA
McSherrystown	PA
Media	PA
Mercersburg	PA
Meyersdale	PA
Midway	PA
Milford	PA
Millersville	PA
Mont Alto	PA
Morrisville	PA
Morton	PA
Mount Pleasant	PA
Nemacolin	PA
New Freedom	PA
New Oxford	PA
North York	PA
Norwood	PA
Oliver	PA
Oxford	PA
Parkesburg	PA
Parkside	PA
Parkville	PA
Penn Wynne	PA
Pennville	PA
Philadelphia	PA
Point Marion	PA
Prospect Park	PA
Quarryville	PA
Red Lion	PA
Republic	PA
Ridley Park	PA
Sharon Hill	PA
Shiloh	PA
Shrewsbury	PA
South Connellsville	PA
Spring Grove	PA
Springfield	PA
Spry	PA
Stewartstown	PA
Strasburg	PA
Susquehanna Trails	PA
Swarthmore	PA
Thorndale	PA
Toughkenamon	PA
Trainer	PA
Uniontown	PA
Upland	PA
Upland	PA
Valley View	PA
Wayne Heights	PA
Waynesboro	PA
Waynesburg	PA
Weigelstown	PA
West Chester	PA
West Goshen	PA
West Grove	PA
West York	PA
Willow Street	PA
Windsor	PA
Woodlyn	PA
Yoe	PA
York	PA
Yeadon	PA
Abbeville	SC
Aiken	SC
Allendale	SC
Anderson	SC
Andrews	SC
Arial	SC
Awendaw	SC
Bamberg	SC
Barnwell	SC
Batesburg	SC
Batesburg-Leesville	SC
Beaufort	SC
Belton	SC
Belvedere	SC
Bennettsville	SC
Berea	SC
Bishopville	SC
Blackville	SC
Blacksburg	SC
Bluffton	SC
Boiling Springs	SC
Boiling Springs	SC
Bowman	SC
Branchville	SC
Brookdale	SC
Bucksport	SC
Buffalo	SC
Burnettown	SC
Burton	SC
Calhoun Falls	SC
Camden	SC
Cane Savannah	SC
Cayce	SC
Centerville	SC
Centerville	SC
Central	SC
Charleston	SC
Cheraw	SC
Cherryvale	SC
Chesnee	SC
Chesterfield	SC
Chester	SC
City View	SC
Clearwater	SC
Clemson	SC
Clinton	SC
Clover	SC
Columbia	SC
Conway	SC
Cowpens	SC
Dalzell	SC
Darlington	SC
Denmark	SC
Dentsville	SC
Dillon	SC
Due West	SC
Duncan	SC
Dunean	SC
Easley	SC
East Gaffney	SC
East Sumter	SC
Edgefield	SC
Edisto	SC
Elgin	SC
Estill	SC
Eureka Mill	SC
Fairfax	SC
Five Forks	SC
Florence	SC
Folly Beach	SC
Forest Acres	SC
Forestbrook	SC
Fort Mill	SC
Fountain Inn	SC
Gaffney	SC
Gantt	SC
Garden City	SC
Gaston	SC
Gayle Mill	SC
Georgetown	SC
Gloverville	SC
Golden Grove	SC
Goose Creek	SC
Gray Court	SC
Great Falls	SC
Greenville	SC
Greenwood	SC
Greer	SC
Hampton	SC
Hanahan	SC
Hardeeville	SC
Hartsville	SC
Hilton Head Island	SC
Holly Hill	SC
Hollywood	SC
Honea Path	SC
Homeland Park	SC
India Hook	SC
Inman	SC
Inman Mills	SC
Irmo	SC
Irwin	SC
Isle of Palms	SC
Iva	SC
Jackson	SC
Joanna	SC
Johnsonville	SC
Johnston	SC
Judson	SC
Kershaw	SC
Kiawah Island	SC
Kingstree	SC
Ladson	SC
Lake City	SC
Lake Wylie	SC
Lakewood	SC
Lancaster	SC
Lancaster Mill	SC
Landrum	SC
Latta	SC
Laurel Bay	SC
Laurens	SC
Leesville	SC
Lesslie	SC
Lexington	SC
Liberty	SC
Little River	SC
Loris	SC
Lyman	SC
Manning	SC
Marion	SC
Mauldin	SC
Mayesville	SC
Mayo	SC
McColl	SC
McCormick	SC
Meggett	SC
Moncks Corner	SC
Mount Pleasant	SC
Mullins	SC
Murphys Estates	SC
Murrells Inlet	SC
Myrtle Beach	SC
New Ellenton	SC
Newberry	SC
Newport	SC
Ninety Six	SC
North Augusta	SC
North Charleston	SC
North Hartsville	SC
North Myrtle Beach	SC
Northlake	SC
Oak Grove	SC
Oakland	SC
Orangeburg	SC
Pacolet	SC
Pageland	SC
Pamplico	SC
Parker	SC
Pendleton	SC
Pickens	SC
Piedmont	SC
Pineridge	SC
Port Royal	SC
Powderville	SC
Privateer	SC
Prosperity	SC
Ravenel	SC
Red Bank	SC
Red Hill	SC
Ridgeland	SC
Ridgeville	SC
Rock Hill	SC
Roebuck	SC
Saint Andrews	SC
Saint George	SC
Saint Matthews	SC
Saint Stephen	SC
Saluda	SC
Sans Souci	SC
Saxon	SC
Seabrook Island	SC
Seneca	SC
Seven Oaks	SC
Shell Point	SC
Shell Point	SC
Simpsonville	SC
Socastee	SC
South Congaree	SC
South Sumter	SC
Southern Shops	SC
Spartanburg	SC
Springdale	SC
Springdale	SC
Saint Andrews	SC
Stateburg	SC
Sullivans Island	SC
Summerton	SC
Summerville	SC
Sumter	SC
Surfside Beach	SC
Taylors	SC
Tega Cay	SC
Timmonsville	SC
Travelers Rest	SC
Union	SC
Utica	SC
Valley Falls	SC
Varnville	SC
Wade Hampton	SC
Walhalla	SC
Walterboro	SC
Ware Shoals	SC
Wedgewood	SC
Welcome	SC
Wellford	SC
West Columbia	SC
Westminster	SC
Whitmire	SC
Wilkinson Heights	SC
Williamston	SC
Williston	SC
Winnsboro	SC
Winnsboro Mills	SC
Woodfield	SC
Woodruff	SC
York	SC
Adamsville	TN
Alamo	TN
Alcoa	TN
Algood	TN
Altamont	TN
Ardmore	TN
Arlington	TN
Ashland City	TN
Athens	TN
Atoka	TN
Bartlett	TN
Baxter	TN
Bean Station	TN
Belle Meade	TN
Bells	TN
Benton	TN
Blaine	TN
Bloomingdale	TN
Blountville	TN
Bluff City	TN
Bolivar	TN
Bradford	TN
Brentwood	TN
Brentwood Estates	TN
Brighton	TN
Brighton	TN
Bristol	TN
Brownsville	TN
Bruceton	TN
Burns	TN
Camden	TN
Carthage	TN
Caryville	TN
Celina	TN
Centerville	TN
Central	TN
Central	TN
Charlotte	TN
Chattanooga	TN
Church Hill	TN
Clarksville	TN
Cleveland	TN
Clifton	TN
Clinton	TN
Collegedale	TN
Collierville	TN
Collinwood	TN
Colonial Heights	TN
Columbia	TN
Condon	TN
Cookeville	TN
Coopertown	TN
Covington	TN
Cowan	TN
Cross Plains	TN
Crossville	TN
Crump	TN
Dandridge	TN
Dayton	TN
Decatur	TN
Decherd	TN
Dickson	TN
Dover	TN
Dresden	TN
Dunlap	TN
Dyer	TN
Dyersburg	TN
Eagleton Village	TN
East Brainerd	TN
East Chattanooga	TN
East Cleveland	TN
East Ridge	TN
Elizabethton	TN
Englewood	TN
Englewood	TN
Erin	TN
Erwin	TN
Estill Springs	TN
Etowah	TN
Fairfield Glade	TN
Fairmount	TN
Fairmount	TN
Fairview	TN
Fall Branch	TN
Farragut	TN
Fayetteville	TN
Forest Hills	TN
Franklin	TN
Gallatin	TN
Gatlinburg	TN
Germantown	TN
Gleason	TN
Goodlettsville	TN
Gordonsville	TN
Gray	TN
Graysville	TN
Green Hill	TN
Greenback	TN
Greenbrier	TN
Greeneville	TN
Greenfield	TN
Gruetli-Laager	TN
Halls	TN
Harriman	TN
Harrison	TN
Harrogate	TN
Hartsville	TN
Henderson	TN
Hendersonville	TN
Henning	TN
Hickory Withe	TN
Hohenwald	TN
Hopewell	TN
Humboldt	TN
Hunter	TN
Hunter	TN
Huntingdon	TN
Jacksboro	TN
Jackson	TN
Jamestown	TN
Jasper	TN
Jefferson City	TN
Jellico	TN
Johnson City	TN
Johnsonville	TN
Jonesborough	TN
Kenton	TN
Kimball	TN
Kingsport	TN
Kingston	TN
Kingston Springs	TN
Knoxville	TN
La Vergne	TN
LaFollette	TN
Lafayette	TN
Lafayette	TN
Lake City	TN
Lake Tansi	TN
Lakeland	TN
Lakesite	TN
Lakewood	TN
Lawrenceburg	TN
Lebanon	TN
Lenoir City	TN
Lewisburg	TN
Lexington	TN
Livingston	TN
Lookout Mountain	TN
Loretto	TN
Loudon	TN
Louisville	TN
Lynchburg	TN
Madisonville	TN
Manchester	TN
Martin	TN
Maryville	TN
Mascot	TN
Mason	TN
Maynardville	TN
McEwen	TN
McKenzie	TN
McMinnville	TN
Memphis	TN
Middle Valley	TN
Midway	TN
Midtown	TN
Milan	TN
Millersville	TN
Millington	TN
Monteagle	TN
Monterey	TN
Morristown	TN
Mosheim	TN
Mount Carmel	TN
Mount Carmel	TN
Mount Juliet	TN
Mount Pleasant	TN
Mountain City	TN
Munford	TN
Murfreesboro	TN
Nashville	TN
New Hope	TN
New Johnsonville	TN
New Market	TN
New South Memphis	TN
New Tazewell	TN
Newbern	TN
Newport	TN
Nolensville	TN
Norris	TN
Oak Grove	TN
Oak Hill	TN
Oak Ridge	TN
Oakland	TN
Obion	TN
Oliver Springs	TN
Oneida	TN
Ooltewah	TN
Paris	TN
Parsons	TN
Pegram	TN
Pigeon Forge	TN
Pikeville	TN
Pine Crest	TN
Pine Crest	TN
Plainview	TN
Pleasant View	TN
Portland	TN
Powells Crossroads	TN
Pulaski	TN
Red Bank	TN
Red Boiling Springs	TN
Ridgely	TN
Ridgetop	TN
Ripley	TN
Roan Mountain	TN
Rockwood	TN
Rogersville	TN
Rural Hill	TN
Rutherford	TN
Rutledge	TN
Savannah	TN
Selmer	TN
Sevierville	TN
Sewanee	TN
Seymour	TN
Shelbyville	TN
Signal Mountain	TN
Smithville	TN
Smyrna	TN
Sneedville	TN
Soddy-Daisy	TN
Somerville	TN
South Carthage	TN
South Cleveland	TN
South Fulton	TN
South Pittsburg	TN
Sparta	TN
Spencer	TN
Spring City	TN
Spring Hill	TN
Springfield	TN
Spurgeon	TN
Surgoinsville	TN
Sweetwater	TN
Tazewell	TN
Tennessee Ridge	TN
Thompson's Station	TN
Three Way	TN
Tiptonville	TN
Tracy City	TN
Trenton	TN
Troy	TN
Tullahoma	TN
Tusculum	TN
Unicoi	TN
Union City	TN
Vonore	TN
Walden	TN
Walnut Hill	TN
Walterhill	TN
Watertown	TN
Waverly	TN
Waynesboro	TN
Westmoreland	TN
White Bluff	TN
White House	TN
White Pine	TN
Whiteville	TN
Whitwell	TN
Wildwood Lake	TN
Winchester	TN
Woodbury	TN
Abilene	TX
Addison	TX
Alamo Heights	TX
Alamo	TX
Albany	TX
Aldine	TX
Aledo	TX
Alice	TX
Allen	TX
Alto	TX
Alton	TX
Alton North  (historical)	TX
Alvarado	TX
Alvin	TX
Alvord	TX
Ames	TX
Ames	TX
Anahuac	TX
Anderson Mill	TX
Angleton	TX
Anna	TX
Annetta	TX
Anson	TX
Aransas Pass	TX
Archer City	TX
Arcola	TX
Argyle	TX
Arlington	TX
Asherton	TX
Atascocita	TX
Athens	TX
Atlanta	TX
Aubrey	TX
Aurora	TX
Austin	TX
Azle	TX
Bacliff	TX
Baird	TX
Balch Springs	TX
Balcones Heights	TX
Ballinger	TX
Bandera	TX
Bangs	TX
Barrett	TX
Bartlett	TX
Barton Creek	TX
Bartonville	TX
Bastrop	TX
Batesville	TX
Baytown	TX
Beach City	TX
Bayou Vista	TX
Beaumont	TX
Bedford	TX
Beeville	TX
Bellaire	TX
Bellmead	TX
Bells	TX
Bellville	TX
Belton	TX
Benavides	TX
Benbrook	TX
Bertram	TX
Beverly	TX
Beverly Hills	TX
Bevil Oaks	TX
Big Sandy	TX
Bishop	TX
Blanco	TX
Bloomington	TX
Blossom	TX
Blue Berry Hill	TX
Blue Mound	TX
Boerne	TX
Bogata	TX
Bolivar Peninsula	TX
Bonham	TX
Bowie	TX
Boyd	TX
Brady	TX
Brazoria	TX
Breckenridge	TX
Brenham	TX
Briar	TX
Bridge City	TX
Bridgeport	TX
Brookshire	TX
Brookside Village	TX
Brownsville	TX
Bruceville-Eddy	TX
Brownwood	TX
Brushy Creek	TX
Bryan	TX
Buchanan Dam	TX
Buffalo	TX
Bullard	TX
Bulverde	TX
Buna	TX
Bunker Hill Village	TX
Burkburnett	TX
Burleson	TX
Burnet	TX
Cactus	TX
Caddo Mills	TX
Caldwell	TX
Calvert	TX
Cameron	TX
Cameron Park	TX
Camp Swift	TX
Canton	TX
Canyon Lake	TX
Carrizo Springs	TX
Carrollton	TX
Carthage	TX
Castle Hills	TX
Castroville	TX
Cedar Hill	TX
Cedar Park	TX
Celina	TX
Center	TX
Center	TX
Central Gardens	TX
César Chávez	TX
Chandler	TX
Channelview	TX
Charlotte	TX
Chico	TX
China	TX
China Grove	TX
Cibolo	TX
Cinco Ranch	TX
Cisco	TX
Citrus City	TX
Clarksville	TX
Clear Lake Shores	TX
Cleburne	TX
Cleveland	TX
Cleveland	TX
Clifton	TX
Cloverleaf	TX
Clute	TX
Clyde	TX
Cockrell Hill	TX
Coleman	TX
College Station	TX
Colleyville	TX
Collinsville	TX
Columbus	TX
Comanche	TX
Combes	TX
Combine	TX
Comfort	TX
Commerce	TX
Conroe	TX
Converse	TX
Cooper	TX
Cooper	TX
Coppell	TX
Copper Canyon	TX
Copperas Cove	TX
Corinth	TX
Corpus Christi	TX
Corrigan	TX
Corsicana	TX
Cottonwood Shores	TX
Cotulla	TX
Crandall	TX
Crockett	TX
Crosby	TX
Cross Mountain	TX
Cross Plains	TX
Crowell	TX
Crowley	TX
Crystal City	TX
Cuero	TX
Cut and Shoot	TX
Daingerfield	TX
Daisetta	TX
Dallas	TX
Dalworthington Gardens	TX
Danbury	TX
Dayton	TX
De Kalb	TX
De Leon	TX
DeCordova	TX
DeSoto	TX
Decatur	TX
Deer Park	TX
Denison	TX
Denton	TX
Deweyville	TX
Diboll	TX
Dickinson	TX
Doffing	TX
Donna	TX
Doolittle	TX
Double Oak	TX
Dripping Springs	TX
Dublin	TX
Duncanville	TX
Eagle Lake	TX
Eagle Mountain	TX
Early	TX
East Bernard	TX
Eastland	TX
Edcouch	TX
Eden	TX
Edgecliff Village	TX
Edgewood	TX
Edinburg	TX
El Campo	TX
El Cenizo	TX
El Lago	TX
Electra	TX
Elgin	TX
Elkhart	TX
Elsa	TX
Emory	TX
Encantada-Ranchito-El Calaboz	TX
Ennis	TX
Escobares	TX
Euless	TX
Evadale	TX
Everman	TX
Fair Oaks Ranch	TX
Fairfield	TX
Fairview	TX
Falfurrias	TX
Farmers Branch	TX
Farmersville	TX
Fate	TX
Ferris	TX
Fifth Street	TX
Flatonia	TX
Florence	TX
Floresville	TX
Flower Mound	TX
Forest Hill	TX
Forney	TX
Fort Worth	TX
Franklin	TX
Frankston	TX
Fredericksburg	TX
Freeport	TX
Freer	TX
Fresno	TX
Friendswood	TX
Frisco	TX
Fulshear	TX
Fulton	TX
Gainesville	TX
Galena Park	TX
Galveston	TX
Ganado	TX
Garceno	TX
Garden Ridge	TX
Gardendale	TX
Garfield	TX
Garland	TX
Gatesville	TX
George West	TX
Georgetown	TX
Giddings	TX
Gilmer	TX
Gladewater	TX
Glen Rose	TX
Glenn Heights	TX
Goldthwaite	TX
Goliad	TX
Gonzales	TX
Gorman	TX
Graham	TX
Granbury	TX
Grand Prairie	TX
Grand Saline	TX
Grandview	TX
Granger	TX
Granite Shoals	TX
Grapeland	TX
Grapevine	TX
Greatwood	TX
Greenville	TX
Gregory	TX
Groesbeck	TX
Groves	TX
Groveton	TX
Gun Barrel City	TX
Gunter	TX
Gunter	TX
Hallettsville	TX
Hallsville	TX
Haltom City	TX
Hamilton	TX
Harker Heights	TX
Harlingen	TX
Harper	TX
Haskell	TX
Haslet	TX
Hawkins	TX
Hearne	TX
Heath	TX
Hebbronville	TX
Hedwig Village	TX
Heidelberg	TX
Helotes	TX
Hemphill	TX
Hempstead	TX
Henrietta	TX
Hewitt	TX
Hickory Creek	TX
Hico	TX
Hidalgo	TX
Hideaway	TX
Highland Park	TX
Highland Village	TX
Highlands	TX
Hill Country Village	TX
Hillsboro	TX
Hitchcock	TX
Holiday Lakes	TX
Holland	TX
Holliday	TX
Hollywood Park	TX
Hondo	TX
Honey Grove	TX
Hooks	TX
Horseshoe Bay	TX
Houston	TX
Howe	TX
Hubbard	TX
Hudson	TX
Hudson	TX
Hudson Bend	TX
Hudson Oaks	TX
Hughes Springs	TX
Humble	TX
Hunters Creek Village	TX
Huntington	TX
Huntsville	TX
Hurst	TX
Hutchins	TX
Hutto	TX
Indian Hills	TX
Inez	TX
Ingleside	TX
Ingram	TX
Iowa Park	TX
Irving	TX
Italy	TX
Itasca	TX
Jacinto City	TX
Jacksboro	TX
Jacksonville	TX
Jamaica Beach	TX
Jarrell	TX
Jasper	TX
Jefferson	TX
Jersey Village	TX
Johnson City	TX
Jollyville	TX
Jones Creek	TX
Jonestown	TX
Joshua	TX
Jourdanton	TX
Junction	TX
Justin	TX
Karnes City	TX
Kaufman	TX
Katy	TX
Keene	TX
Keller	TX
Kemah	TX
Kemp	TX
Kenedy	TX
Kennedale	TX
Kempner	TX
Kerens	TX
Kerrville	TX
Kilgore	TX
Killeen	TX
Kingsland	TX
Kingsville	TX
Kirby	TX
Kirbyville	TX
Knox City	TX
Kountze	TX
Krugerville	TX
Krum	TX
Kyle	TX
La Blanca	TX
La Coste	TX
La Feria	TX
La Grange	TX
La Grulla	TX
La Homa	TX
La Joya	TX
La Marque	TX
La Porte	TX
La Pryor	TX
La Puerta	TX
La Rosita	TX
La Vernia	TX
La Victoria	TX
La Villa	TX
Lacy-Lakeview	TX
Lago Vista	TX
Laguna Heights	TX
Laguna Vista	TX
Lake Brownwood	TX
Lake Dallas	TX
Lake Jackson	TX
Lake Kiowa	TX
Lake Worth	TX
Lakehills	TX
Lakeside	TX
Lakeside City	TX
Lakeway	TX
Lampasas	TX
Lancaster	TX
Laredo Ranchettes	TX
Laredo	TX
Las Lomas	TX
Lasara	TX
Laureles	TX
League City	TX
Leander	TX
Leon Valley	TX
Leonard	TX
Lewisville	TX
Lexington	TX
Liberty	TX
Liberty City	TX
Liberty Hill	TX
Lindale	TX
Linden	TX
Little Elm	TX
Little River-Academy	TX
Live Oak	TX
Livingston	TX
Llano	TX
Llano Grande	TX
Lockhart	TX
Lone Star	TX
Longview	TX
Lopezville	TX
Lorena	TX
Los Alvarez	TX
Los Fresnos	TX
Los Indios	TX
Los Villareales	TX
Lost Creek	TX
Louise	TX
Lowry Crossing	TX
Lucas	TX
Lufkin	TX
Luling	TX
Lumberton	TX
Lyford	TX
Lytle	TX
Mabank	TX
Madisonville	TX
Magnolia	TX
Malakoff	TX
Manor	TX
Mansfield	TX
Manvel	TX
Marble Falls	TX
Marion	TX
Markham	TX
Marlin	TX
Marshall	TX
Mart	TX
Martindale	TX
Mason	TX
Mathis	TX
Maud	TX
Mauriceville	TX
McAllen	TX
McGregor	TX
McKinney	TX
McQueeney	TX
Meadowlakes	TX
Meadows Place	TX
Medina	TX
Medina	TX
Melissa	TX
Menard	TX
Mercedes	TX
Meridian	TX
Mesquite	TX
Mexia	TX
Midlothian	TX
Midway North	TX
Midway South	TX
Mila Doce	TX
Milam	TX
Mineola	TX
Mineral Wells	TX
Mission	TX
Mission Bend	TX
Missouri City	TX
Mont Belvieu	TX
Monte Alto	TX
Moody	TX
Morgans Point Resort	TX
Mount Pleasant	TX
Mount Vernon	TX
Muenster	TX
Munday	TX
Muniz	TX
Murphy	TX
Nacogdoches	TX
Naples	TX
Nash	TX
Nash	TX
Nassau Bay	TX
Navasota	TX
Nederland	TX
Needville	TX
New Boston	TX
New Braunfels	TX
New Summerfield	TX
New Territory	TX
Newark	TX
Newton	TX
Nixon	TX
Nocona	TX
Nolanville	TX
North Alamo	TX
North Escobares	TX
North Richland Hills	TX
Northcliff	TX
Northcrest	TX
Northlake	TX
Nurillo	TX
Oak Leaf	TX
Oak Point	TX
Oak Ridge North	TX
Oak Trail Shores	TX
Odem	TX
Old River-Winfree	TX
Olivarez	TX
Olmito	TX
Olmos Park	TX
Olney	TX
Onalaska	TX
Onion Creek	TX
Orange	TX
Orange Grove	TX
Ore City	TX
Overton	TX
Ovilla	TX
Oyster Creek	TX
Palacios	TX
Palestine	TX
Palm Valley	TX
Palmer	TX
Palmhurst	TX
Palmview	TX
Palmview South	TX
Panorama Village	TX
Pantego	TX
Paris	TX
Parker	TX
Pasadena	TX
Patton Village	TX
Pearland	TX
Pearsall	TX
Pecan Acres	TX
Pecan Grove	TX
Pecan Plantation	TX
Pelican Bay	TX
Penitas	TX
Pflugerville	TX
Pharr	TX
Pilot Point	TX
Pinehurst	TX
Pinehurst	TX
Pinewood Estates	TX
Piney Point Village	TX
Pittsburg	TX
Plano	TX
Pleak	TX
Pleasanton	TX
Plum Grove	TX
Point	TX
Port Aransas	TX
Port Arthur	TX
Port Isabel	TX
Port Lavaca	TX
Port Neches	TX
Porter Heights	TX
Portland	TX
Poteet	TX
Poth	TX
Potosi	TX
Pottsboro	TX
Prairie View	TX
Premont	TX
Primera	TX
Princeton	TX
Progreso	TX
Prosper	TX
Quanah	TX
Queen City	TX
Quinlan	TX
Quitman	TX
Rancho Alegre	TX
Rancho Viejo	TX
Ranger	TX
Raymondville	TX
Red Oak	TX
Redwood	TX
Refugio	TX
Rendon	TX
Reno	TX
Reno	TX
Richardson	TX
Richland Hills	TX
Richmond	TX
Richwood	TX
Rio Bravo	TX
Rio Grande City	TX
Rio Hondo	TX
River Oaks	TX
Roanoke	TX
Robinson	TX
Robstown	TX
Rockdale	TX
Rockwall	TX
Rockport	TX
Rogers	TX
Rollingwood	TX
Roman Forest	TX
Roma-Los Saenz	TX
Rosebud	TX
Rosenberg	TX
Round Rock	TX
Rowlett	TX
Royse City	TX
Runaway Bay	TX
Runge	TX
Rusk	TX
Sabinal	TX
Sachse	TX
Saginaw	TX
Saint Hedwig	TX
Salado	TX
San Antonio	TX
San Augustine	TX
San Benito	TX
San Carlos	TX
San Diego	TX
San Juan	TX
San Leon	TX
San Marcos	TX
San Saba	TX
Sanger	TX
Sansom Park	TX
Santa Anna	TX
Santa Fe	TX
Santa Rosa	TX
Scenic Oaks	TX
Schertz	TX
Schulenburg	TX
Scissors	TX
Seabrook	TX
Seadrift	TX
Seagoville	TX
Sealy	TX
Sebastian	TX
Seguin	TX
Selma	TX
Serenada	TX
Seven Points	TX
Seymour	TX
Shady Hollow	TX
Shady Shores	TX
Shamrock	TX
Shavano Park	TX
Sheldon	TX
Shenandoah	TX
Shepherd	TX
Sherman	TX
Shiner	TX
Shoreacres	TX
Sienna Plantation	TX
Silsbee	TX
Sinton	TX
Skidmore	TX
Smithville	TX
Somerset	TX
Somerville	TX
Sour Lake	TX
South Alamo	TX
South Houston	TX
South Padre Island	TX
South Point	TX
Southlake	TX
Southmayd	TX
Southside Place	TX
Sparks	TX
Splendora	TX
Spring	TX
Spring Valley	TX
Springtown	TX
Stafford	TX
Stamford	TX
Stephenville	TX
Stockdale	TX
Stowell	TX
Sugar Land	TX
Sullivan City	TX
Sulphur Springs	TX
Sunnyvale	TX
Sweeny	TX
Taft	TX
Taft Southwest  (historical)	TX
Talty	TX
Tatum	TX
Taylor	TX
Taylor Lake Village	TX
Teague	TX
Tenaha	TX
Temple	TX
Terrell	TX
Terrell Hills	TX
Texarkana	TX
Texas City	TX
The Colony	TX
The Hills	TX
The Woodlands	TX
Thorndale	TX
Three Rivers	TX
Timberwood Park	TX
Timpson	TX
Tomball	TX
Tool	TX
Trinidad	TX
Trinity	TX
Trophy Club	TX
Troup	TX
Troy	TX
Tye	TX
Tyler	TX
Universal City	TX
University Park	TX
Uvalde	TX
Uvalde Estates	TX
Valley Mills	TX
Van	TX
Van Alstyne	TX
Van Vleck	TX
Venus	TX
Vernon	TX
Victoria	TX
Vidor	TX
Waco	TX
Wake Village	TX
Waller	TX
Waskom	TX
Watauga	TX
Waxahachie	TX
Weatherford	TX
Webster	TX
Weimar	TX
Wells Branch	TX
Weslaco	TX
West	TX
West Columbia	TX
West Lake Hills	TX
West Livingston	TX
West Orange	TX
West Sharyland	TX
West Tawakoni	TX
West University Place	TX
Westworth	TX
Wharton	TX
White Oak	TX
White Settlement	TX
Whitehouse	TX
Whitesboro	TX
Whitewright	TX
Whitney	TX
Wichita Falls	TX
Wild Peach Village	TX
Willis	TX
Willow Park	TX
Wills Point	TX
Wilmer	TX
Wimberley	TX
Windemere	TX
Windcrest	TX
Winnie	TX
Winnsboro	TX
Winters	TX
Wolfe City	TX
Woodbranch	TX
Woodcreek	TX
Woodsboro	TX
Woodville	TX
Woodway	TX
Wortham	TX
Wyldwood	TX
Wylie	TX
Yoakum	TX
Yorktown	TX
Zapata	TX
Abingdon	VA
Adwolf	VA
Alexandria	VA
Altavista	VA
Amherst	VA
Annandale	VA
Appalachia	VA
Appomattox	VA
Aquia Harbour	VA
Arlington	VA
Ashland	VA
Atkins	VA
Baileys Crossroads	VA
Bassett	VA
Bedford	VA
Belle Haven	VA
Bellwood	VA
Bensley	VA
Berryville	VA
Big Stone Gap	VA
Blackstone	VA
Blacksburg	VA
Blue Ridge	VA
Bluefield	VA
Bon Air	VA
Bridgewater	VA
Bristol	VA
Broadway	VA
Brookneal	VA
Buchanan	VA
Buena Vista	VA
Bull Run	VA
Burke	VA
Cana	VA
Cape Charles	VA
Castlewood	VA
Cave Spring	VA
Cedar Bluff	VA
Cedar Bluff	VA
Centreville	VA
Chamberlayne	VA
Chantilly	VA
Charlottesville	VA
Chase City	VA
Chatham	VA
Chatmoss	VA
Chesapeake	VA
Chester	VA
Chesterfield Court House	VA
Chilhowie	VA
Chincoteague	VA
Christiansburg	VA
Clarksville	VA
Claypool Hill	VA
Clifton Forge	VA
Clintwood	VA
Cloverdale	VA
Coeburn	VA
Collinsville	VA
Colonial Beach	VA
Colonial Heights	VA
Courtland	VA
Covington	VA
Craigsville	VA
Crewe	VA
Crimora	VA
Crozet	VA
Culpeper	VA
Dahlgren	VA
Dale City	VA
Daleville	VA
Damascus	VA
Danville	VA
Dayton	VA
Dooms	VA
Dryden	VA
Dublin	VA
Dumfries	VA
Dumbarton	VA
Dunn Loring	VA
East Hampton	VA
East Highland Park	VA
Elkton	VA
Emporia	VA
Ettrick	VA
Exmore	VA
Fairfax	VA
Fairlawn	VA
Fairlawn	VA
Falls Church	VA
Falmouth	VA
Farmville	VA
Ferrum	VA
Fishersville	VA
Forest	VA
Fort Lee	VA
Franconia	VA
Franklin	VA
Fredericksburg	VA
Front Royal	VA
Gainesville	VA
Galax	VA
Gate City	VA
Glade Spring	VA
Glasgow	VA
Glen Allen	VA
Gloucester Courthouse	VA
Gloucester Point	VA
Gordonsville	VA
Great Falls	VA
Gretna	VA
Grottoes	VA
Groveton	VA
Halifax	VA
Hampden Sydney	VA
Hampton	VA
Harrisonburg	VA
Haymarket	VA
Herndon	VA
Highland Springs	VA
Hillsville	VA
Hollins	VA
Hopewell	VA
Horse Pasture	VA
Huntington	VA
Hurt	VA
Hybla Valley	VA
Idylwood	VA
Jefferson	VA
Jolivue	VA
Kenbridge	VA
Kilmarnock	VA
Lake Barcroft	VA
Lake Monticello	VA
Lake Ridge	VA
Lakeside	VA
Laurel	VA
Lawrenceville	VA
Laymantown	VA
Lebanon	VA
Leesburg	VA
Lexington	VA
Lincolnia	VA
Linton Hall	VA
Loch Lomond	VA
Lorton	VA
Louisa	VA
Lovettsville	VA
Luray	VA
Lynchburg	VA
Lyndhurst	VA
Madison Heights	VA
Manassas	VA
Manassas Park	VA
Mantua	VA
Marion	VA
Martinsville	VA
Massanutten	VA
Matoaca	VA
McLean	VA
Mechanicsville	VA
Merrifield	VA
Merrimac	VA
Merrimac	VA
Middletown	VA
Montclair	VA
Montrose	VA
Mount Jackson	VA
Narrows	VA
Narrows	VA
New Market	VA
Newington	VA
Newport News	VA
Nokesville	VA
Norfolk	VA
North Shore	VA
North Springfield	VA
Norton	VA
Oakton	VA
Onancock	VA
Orange	VA
Patrick Springs	VA
Pearisburg	VA
Pembroke	VA
Pennington Gap	VA
Petersburg	VA
Pimmit Hills	VA
Poquoson	VA
Portsmouth	VA
Portsmouth Heights	VA
Pound	VA
Pulaski	VA
Purcellville	VA
Radford	VA
Raven	VA
Reston	VA
Richmond	VA
Richlands	VA
Roanoke	VA
Rocky Mount	VA
Rose Hill	VA
Rural Retreat	VA
Rushmere	VA
Rustburg	VA
Salem	VA
Saltville	VA
Seven Corners	VA
Shawsville	VA
Shenandoah	VA
Smithfield	VA
South Boston	VA
South Hill	VA
South Suffolk	VA
Spotsylvania Courthouse	VA
Springfield	VA
Stanley	VA
Stanleytown	VA
Staunton	VA
Stephens City	VA
Sterling	VA
Strasburg	VA
Stuarts Draft	VA
Sudley	VA
Suffolk	VA
Tappahannock	VA
Tazewell	VA
Timberlake	VA
Timberville	VA
Triangle	VA
Tuckahoe	VA
Tysons Corner	VA
Union Hall	VA
Verona	VA
Victoria	VA
Vienna	VA
Vinton	VA
Virginia Beach	VA
Wakefield	VA
Warrenton	VA
Warsaw	VA
Waverly	VA
Waynesboro	VA
Weber City	VA
Weber City	VA
West Gate	VA
West Lynchburg	VA
West Point	VA
West Springfield	VA
Weyers Cave	VA
Williamsburg	VA
Winchester	VA
Wolf Trap	VA
Woodbridge	VA
Woodlawn	VA
Woodstock	VA
Wyndham	VA
Wytheville	VA
Yorkshire	VA
Alderson	WV
Alum Creek	WV
Ansted	WV
Athens	WV
Barboursville	WV
Barrackville	WV
Beaver	WV
Beckley	WV
Belington	WV
Belle	WV
Belmont	WV
Bethlehem	WV
Blennerhassett	WV
Bluefield	WV
Boaz	WV
Bolivar	WV
Bradley	WV
Bridgeport	WV
Brookhaven	WV
Buckhannon	WV
Buffalo	WV
Cameron	WV
Cassville	WV
Ceredo	WV
Chapmanville	WV
Charles Town	WV
Charleston	WV
Chattaroy	WV
Cheat Lake	WV
Chesapeake	WV
Clarksburg	WV
Clendenin	WV
Coal City	WV
Coal Fork	WV
Crab Orchard	WV
Craigsville	WV
Cross Lanes	WV
Culloden	WV
Daniels	WV
Despard	WV
Dunbar	WV
Eleanor	WV
Elkins	WV
Elkview	WV
Fairlea	WV
Fairmont	WV
Fayetteville	WV
Fort Ashby	WV
Gilbert Creek	WV
Glenville	WV
Glendale	WV
Grafton	WV
Hamlin	WV
Harrisville	WV
Harts	WV
Hinton	WV
Holden	WV
Huntington	WV
Hurricane	WV
Inwood	WV
Kenova	WV
Keyser	WV
Kingwood	WV
Lewisburg	WV
Logan	WV
Lubeck	WV
Mabscott	WV
MacArthur	WV
Madison	WV
Mallory	WV
Mannington	WV
Marlinton	WV
Marmet	WV
Martinsburg	WV
Mason	WV
McMechen	WV
Milton	WV
Mineralwells	WV
Montgomery	WV
Moorefield	WV
Morgantown	WV
Moundsville	WV
Mount Hope	WV
Mullens	WV
New Martinsville	WV
New Haven	WV
Nitro	WV
Nutter Fort	WV
Oak Hill	WV
Oceana	WV
Paden City	WV
Parkersburg	WV
Parsons	WV
Pea Ridge	WV
Pennsboro	WV
Petersburg	WV
Philippi	WV
Piedmont	WV
Pinch	WV
Piney View	WV
Pleasant Valley	WV
Poca	WV
Point Pleasant	WV
Powellton	WV
Princeton	WV
Prosperity	WV
Rainelle	WV
Ranson	WV
Ravenswood	WV
Richwood	WV
Ripley	WV
Romney	WV
Ronceverte	WV
Saint Albans	WV
Saint Marys	WV
Salem	WV
Shady Spring	WV
Shepherdstown	WV
Shinnston	WV
Sissonville	WV
Sistersville	WV
Sophia	WV
South Charleston	WV
Spencer	WV
Stanaford	WV
Star City	WV
Stonewood	WV
Summersville	WV
Switzer	WV
Teays Valley	WV
Terra Alta	WV
Tornado	WV
Vienna	WV
Washington	WV
Wayne	WV
Webster Springs	WV
Welch	WV
Weston	WV
Westover	WV
White Sulphur Springs	WV
Wiley Ford	WV
Williamson	WV
Williamstown	WV
Winfield	WV
Elba	AL
Sherwood	AR
Franklin	IN
Newton	IL
Linn	MO
Villa Ridge	MO
Rosedale	MS
Shaw	MS
Merchantville	NJ
Oak Valley	NJ
Bremen	OH
Chillicothe	OH
Coalgate	OK
Dilley	TX
Devine	TX
Hickory Creek	TX
Wallis	TX
Bay City	TX
Wise	VA
Abbeville	AL
Adamsville	AL
Alabaster	AL
Albertville	AL
Alexander City	AL
Alexandria	AL
Aliceville	AL
Andalusia	AL
Anniston	AL
Arab	AL
Argo	AL
Ardmore	AL
Athens	AL
Ashford	AL
Ashland	AL
Ashville	AL
Atmore	AL
Attalla	AL
Auburn	AL
South Coventry	CT
Tariffville	CT
Gladbrook	IA
Canton	IL
Deer Park	IL
Coventry Lake	CT
Glendale Heights	IL
Lena	IL
Cromwell	CT
East Falmouth	MA
Crystal Lake	CT
North Andover	MA
Revere	MA
West Barnstable	MA
Alfred	ME
Danbury	CT
Berwick	ME
Hope	ME
Danielson	CT
Darien	CT
Rockland	ME
Union	ME
Inkster	MI
Edina	MO
Derby	CT
Camillus	NY
Clyde	NY
Durham	CT
Wayland	NY
Watervliet	NY
East Brooklyn	CT
Camden	OH
Cleveland Heights	OH
Genoa	OH
East Haddam	CT
East Hampton	CT
East Hartford	CT
East Haven	CT
Carnegie	PA
East Norwalk	CT
Ellington	CT
Fairfield	CT
Farmington	CT
Georgetown	CT
Glastonbury	CT
Glastonbury Center	CT
Greenwich	CT
Groton	CT
Guilford	CT
Hamden	CT
Hartford	CT
Hazardville	CT
Hebron	CT
Heritage Village	CT
Higganum	CT
Jewett City	CT
Kensington	CT
Killingly Center	CT
Lake Pocotopaug	CT
Ledyard Center	CT
Long Hill	CT
Madison	CT
Manchester	CT
Mansfield Center	CT
Mansfield City	CT
Meriden	CT
Middletown	CT
Milford	CT
Montville Center	CT
Moodus	CT
Moosup	CT
Mystic	CT
Naugatuck	CT
New Britain	CT
New Haven	CT
New London	CT
New Milford	CT
New Preston	CT
Newington	CT
Niantic	CT
Noank	CT
North Branford	CT
North Granby	CT
North Grosvenor Dale	CT
North Haven	CT
North Stamford	CT
Norwalk	CT
Norwich	CT
Oakville	CT
Old Greenwich	CT
Old Mystic	CT
Old Saybrook	CT
Orange	CT
Oxford	CT
Pawcatuck	CT
Plainfield	CT
Plainville	CT
Plymouth	CT
Poquonock Bridge	CT
Portland	CT
Prospect	CT
Preston City	CT
Putnam	CT
Quinebaug	CT
Ridgefield	CT
Rockville	CT
Salmon Brook	CT
Saybrook Manor	CT
Seymour	CT
Shelton	CT
Sherwood Manor	CT
Somers	CT
South Windham	CT
South Windsor	CT
South Woodstock	CT
Southbury	CT
Southwood Acres	CT
Stafford	CT
Stafford Springs	CT
Stamford	CT
Storrs	CT
Stratford	CT
Suffield Depot	CT
Terramuggus	CT
Terryville	CT
Thompson	CT
Thompsonville	CT
Tolland	CT
Torrington	CT
Trumbull	CT
Wallingford	CT
Waterbury	CT
Watertown	CT
Wauregan	CT
Weatogue	CT
West Hartford	CT
West Haven	CT
West Simsbury	CT
West Torrington	CT
Westport	CT
Wethersfield	CT
Willimantic	CT
Winchester Center	CT
Windham	CT
Windsor Locks	CT
Winsted	CT
Wolcott	CT
Woodbridge	CT
Woodbury	CT
Woodmont	CT
Ackley	IA
Adel	IA
Akron	IA
Albia	IA
Algona	IA
Alta	IA
Alton	IA
Altoona	IA
Ames	IA
Anamosa	IA
Anita	IA
Ankeny	IA
Arnolds Park	IA
Asbury	IA
Atkins	IA
Atlantic	IA
Audubon	IA
Avoca	IA
Baxter	IA
Bedford	IA
Belle Plaine	IA
Bellevue	IA
Belmond	IA
Bettendorf	IA
Bloomfield	IA
Blue Grass	IA
Bondurant	IA
Boone	IA
Britt	IA
Brooklyn	IA
Buffalo (historical)	IA
Buffalo	IA
Burlington	IA
Calmar	IA
Camanche	IA
Carlisle	IA
Carroll	IA
Carter Lake	IA
Cascade	IA
Cedar Falls	IA
Cedar Rapids	IA
Center Point	IA
Centerville	IA
Centerville	IA
Central City	IA
Chariton	IA
Charles City	IA
Cherokee	IA
Clarence	IA
Clarinda	IA
Clarion	IA
Clarksville	IA
Clear Lake	IA
Clinton	IA
Clinton Stock Yards	IA
Clive	IA
Colfax	IA
Columbus Junction	IA
Conrad	IA
Coon Rapids	IA
Coralville	IA
Corning	IA
Corydon	IA
Council Bluffs	IA
Cresco	IA
Creston	IA
Dallas Center	IA
Davenport	IA
De Soto	IA
De Witt	IA
Decorah	IA
Denison	IA
Denver	IA
Des Moines	IA
Dike	IA
Dubuque	IA
Dunlap	IA
Durant	IA
Dyersville	IA
Dysart	IA
Eagle Grove	IA
Earlham	IA
Eddyville	IA
Eldora	IA
Eldridge	IA
Elk Run Heights	IA
Elkader	IA
Ely	IA
Emmetsburg	IA
Epworth	IA
Estherville	IA
Evansdale	IA
Fairbank	IA
Fairfax	IA
Fairfield	IA
Farley	IA
Fayette	IA
Forest City	IA
Fort Dodge	IA
Fort Madison	IA
Garner	IA
George	IA
Gilbert	IA
Glenwood	IA
Glidden	IA
Gowrie	IA
Greene	IA
Greenfield	IA
Grimes	IA
Grinnell	IA
Grundy Center	IA
Guthrie Center	IA
Guttenberg	IA
Hamburg	IA
Hampton	IA
Harlan	IA
Hartley	IA
Hawarden	IA
Hiawatha	IA
Holstein	IA
Hudson	IA
Hull	IA
Humboldt	IA
Huxley	IA
Ida Grove	IA
Independence	IA
Indianola	IA
Iowa City	IA
Iowa Falls	IA
Jefferson	IA
Jesup	IA
Jewell	IA
Johnston	IA
Kalona	IA
Keokuk	IA
Keosauqua	IA
Kingsley	IA
Knoxville	IA
La Porte City	IA
Lake City	IA
Lake Mills	IA
Lake View	IA
Lamoni	IA
Laurens	IA
Le Claire	IA
Le Mars	IA
Lenox	IA
Leon	IA
Lisbon	IA
Logan	IA
Lone Tree	IA
Madrid	IA
Malvern	IA
Manchester	IA
Manly	IA
Manning	IA
Manson	IA
Mapleton	IA
Maquoketa	IA
Marcus	IA
Marengo	IA
Marion	IA
Marshalltown	IA
Mason City	IA
Mechanicsville	IA
Mediapolis	IA
Melcher-Dallas	IA
Milford	IA
Missouri Valley	IA
Mitchellville	IA
Monona	IA
Monroe	IA
Montezuma	IA
Monticello	IA
Mount Ayr	IA
Mount Pleasant	IA
Mount Vernon	IA
Moville	IA
Muscatine	IA
Nashua	IA
Nevada	IA
New Hampton	IA
New London	IA
New Sharon	IA
Newhall	IA
Newton	IA
Nora Springs	IA
North English	IA
North Liberty	IA
Northwood	IA
Norwalk	IA
Oakland	IA
Oakland	IA
Odebolt	IA
Oelwein	IA
Ogden	IA
Onawa	IA
Orange City	IA
Osage	IA
Osceola	IA
Oskaloosa	IA
Ottumwa	IA
Panora	IA
Park View	IA
Parkersburg	IA
Paullina	IA
Pella	IA
Perry	IA
Pleasant Hill	IA
Pleasantville	IA
Pocahontas	IA
Polk City	IA
Postville	IA
Prairie City	IA
Red Oak	IA
Reinbeck	IA
Remsen	IA
Robins	IA
Rock Rapids	IA
Rock Valley	IA
Rockwell City	IA
Roland	IA
Sac City	IA
Saint Ansgar	IA
Sanborn	IA
Saylorville	IA
Sergeant Bluff	IA
Sheldon	IA
Shell Rock	IA
Shenandoah	IA
Sidney	IA
Sibley	IA
Sigourney	IA
Sioux Center	IA
Sioux City	IA
Slater	IA
Sloan	IA
Solon	IA
Spencer	IA
Spirit Lake	IA
Springville	IA
State Center	IA
Storm Lake	IA
Story City	IA
Strawberry Point	IA
Stuart	IA
Sumner	IA
Tama	IA
Tiffin	IA
Tipton	IA
Toledo	IA
Traer	IA
Tripoli	IA
Urbana	IA
Urbandale	IA
Villisca	IA
Vinton	IA
Walcott	IA
Walford	IA
Wapello	IA
Washington	IA
Waterloo	IA
Waukee	IA
Waukon	IA
Waverly	IA
Webster City	IA
Wellman	IA
West Branch	IA
West Burlington	IA
West Des Moines	IA
West Liberty	IA
West Union	IA
Williamsburg	IA
Wilton	IA
Windsor Heights	IA
Winfield	IA
Winterset	IA
Woodbine	IA
Woodward	IA
Abingdon	IL
Addison	IL
Aledo	IL
Algonquin	IL
Alsip	IL
Amboy	IL
Andalusia	IL
Antioch	IL
Arlington Heights	IL
Ashton	IL
Astoria	IL
Atlanta	IL
Aurora	IL
Bannockburn	IL
Barrington	IL
Barrington Hills	IL
Bartlett	IL
Bartonville	IL
Batavia	IL
Beach Park	IL
Beardstown	IL
Beecher	IL
Bellevue	IL
Bellwood	IL
Belvidere	IL
Bensenville	IL
Berkeley	IL
Berwyn	IL
Bloomingdale	IL
Bloomington	IL
Blue Island	IL
Bolingbrook	IL
Boulder Hill	IL
Bourbonnais	IL
Bradley	IL
Braidwood	IL
Bridgeview	IL
Broadview	IL
Brookfield	IL
Buffalo Grove	IL
Burbank	IL
Burnham	IL
Burr Ridge	IL
Bushnell	IL
Byron	IL
Calumet City	IL
Calumet Park	IL
Cambridge	IL
Camp Point	IL
Capron	IL
Carbon Cliff	IL
Carol Stream	IL
Carpentersville	IL
Carthage	IL
Carthage	IL
Cary	IL
Catlin	IL
Central City	IL
Champaign	IL
Channahon	IL
Channel Lake	IL
Chatsworth	IL
Chebanse	IL
Chenoa	IL
Cherry Valley	IL
Chicago	IL
Chicago Heights	IL
Chicago Ridge	IL
Chillicothe	IL
Cicero	IL
Clarendon Hills	IL
Clifton	IL
Clinton	IL
Coal City	IL
Coal Valley	IL
Colchester	IL
Colona	IL
Cortland	IL
Country Club Hills	IL
Countryside	IL
Crest Hill	IL
Crestwood	IL
Crete	IL
Creve Coeur	IL
Crystal Lake	IL
Crystal Lawns	IL
Cuba	IL
Cuba	IL
Danvers	IL
Danville	IL
Darien	IL
DeKalb	IL
Deer Park	IL
Deerfield	IL
Delavan	IL
Depue	IL
Des Plaines	IL
Diamond	IL
Dixmoor	IL
Dixon	IL
Dolton	IL
Downers Grove	IL
Durand	IL
Dwight	IL
Earlville	IL
East Dundee	IL
East Dubuque	IL
East Hazel Crest	IL
East Moline	IL
East Peoria	IL
El Paso	IL
Elburn	IL
Elgin	IL
Elk Grove Village	IL
Elmhurst	IL
Elmwood	IL
Elmwood Park	IL
Elwood	IL
Erie	IL
Eureka	IL
Evanston	IL
Evergreen Park	IL
Fairbury	IL
Fairfield	IL
Fairmont	IL
Farmer City	IL
Farmington	IL
Farmington	IL
Fisher	IL
Flanagan	IL
Flossmoor	IL
Ford Heights	IL
Forest Lake	IL
Forest Park	IL
Forrest	IL
Forreston	IL
Fox Lake	IL
Fox Lake Hills	IL
Fox River Grove	IL
Frankfort	IL
Frankfort Square	IL
Franklin Grove	IL
Franklin Park	IL
Freeport	IL
Fulton	IL
Gages Lake	IL
Galena	IL
Galesburg	IL
Galva	IL
Gardner	IL
Geneseo	IL
Geneva	IL
Genoa	IL
Georgetown	IL
Germantown Hills	IL
Gibson City	IL
Gifford	IL
Gilberts	IL
Gilman	IL
Glen Ellyn	IL
Glenview	IL
Glenwood	IL
Goodings Grove	IL
Glencoe	IL
Grandwood Park	IL
Grant Park	IL
Granville	IL
Grayslake	IL
Green Oaks	IL
Green Rock	IL
Gridley	IL
Gurnee	IL
Hainesville	IL
Hamilton	IL
Hampshire	IL
Hampton	IL
Hanover Park	IL
Harvard	IL
Harvey	IL
Harwood Heights	IL
Havana	IL
Hawthorn Woods	IL
Hazel Crest	IL
Hebron	IL
Henry	IL
Herscher	IL
Heyworth	IL
Hickory Hills	IL
Highland Park	IL
Highwood	IL
Hillcrest	IL
Hillside	IL
Hinckley	IL
Hinsdale	IL
Hodgkins	IL
Hoffman Estates	IL
Homer	IL
Hometown	IL
Homewood	IL
Hoopeston	IL
Hudson	IL
Huntley	IL
Indian Head Park	IL
Ingalls Park	IL
Inverness	IL
Island Lake	IL
Itasca	IL
Johnsburg	IL
Joliet	IL
Justice	IL
Kankakee	IL
Kenilworth	IL
Kewanee	IL
Kildeer	IL
Kirkland	IL
Knoxville	IL
La Grange	IL
La Grange Park	IL
La Harpe	IL
La Salle	IL
Lacon	IL
Ladd	IL
Lake Barrington	IL
Lake Bluff	IL
Lake Catherine	IL
Lake Forest	IL
Lake Summerset	IL
Lake Villa	IL
Lake Zurich	IL
Lake in the Hills	IL
Lake of the Woods	IL
Lakemoor	IL
Lakewood	IL
Lakewood Shores	IL
Lanark	IL
Lansing	IL
Le Roy	IL
Lemont	IL
Lewistown	IL
Lexington	IL
Libertyville	IL
Lincoln	IL
Lincolnshire	IL
Lincolnwood	IL
Lindenhurst	IL
Lisle	IL
Lockport	IL
Lombard	IL
Long Grove	IL
Long Lake	IL
Loves Park	IL
Lynwood	IL
Lynwood	IL
Lyons	IL
Machesney Park	IL
Mackinaw	IL
Macomb	IL
Mahomet	IL
Manhattan	IL
Manito	IL
Manteno	IL
Maple Park	IL
Marengo	IL
Markham	IL
Maroa	IL
Marquette Heights	IL
Marseilles	IL
Mason City	IL
Matteson	IL
Maywood	IL
McCullom Lake	IL
McHenry	IL
Melrose Park	IL
Mendota	IL
Merrionette Park	IL
Metamora	IL
Midlothian	IL
Milan	IL
Milford	IL
Minier	IL
Minonk	IL
Minooka	IL
Mokena	IL
Moline	IL
Momence	IL
Monee	IL
Monmouth	IL
Montgomery	IL
Monticello	IL
Morris	IL
Morrison	IL
Morton	IL
Morton Grove	IL
Mount Carroll	IL
Mount Morris	IL
Mount Prospect	IL
Mount Pulaski	IL
Mundelein	IL
Naperville	IL
Nauvoo	IL
New Lenox	IL
Niles	IL
Normal	IL
Norridge	IL
North Aurora	IL
North Barrington	IL
North Chicago	IL
North Pekin	IL
North Peoria	IL
North Riverside	IL
Northbrook	IL
Northfield	IL
Northlake	IL
Oak Brook	IL
Oak Forest	IL
Oak Grove	IL
Oak Lawn	IL
Oak Park	IL
Oakbrook Terrace	IL
Oakwood	IL
Oakwood Hills	IL
Odell	IL
Oglesby	IL
Olympia Fields	IL
Onarga	IL
Oquawka	IL
Oregon	IL
Orion	IL
Orland Hills	IL
Orland Park	IL
Oswego	IL
Ottawa	IL
Palatine	IL
Palos Heights	IL
Palos Hills	IL
Palos Park	IL
Park City	IL
Park Forest	IL
Park Ridge	IL
Paxton	IL
Pecatonica	IL
Pekin	IL
Peoria	IL
Peoria Heights	IL
Peotone	IL
Peru	IL
Petersburg	IL
Philo	IL
Phoenix	IL
Pistakee Highlands	IL
Plainfield	IL
Plano	IL
Polo	IL
Pontiac	IL
Poplar Grove	IL
Port Barrington	IL
Port Byron	IL
Posen	IL
Prairie Grove	IL
Preston Heights	IL
Princeton	IL
Princeville	IL
Prophetstown	IL
Prospect Heights	IL
Rantoul	IL
Richmond	IL
Richmond	IL
Richton Park	IL
River Forest	IL
River Grove	IL
Riverdale	IL
Riverside	IL
Riverwoods	IL
Roanoke	IL
Robbins	IL
Rochelle	IL
Rock Falls	IL
Rock Island	IL
Rockdale	IL
Rockford	IL
Rockton	IL
Rolling Meadows	IL
Rome	IL
Romeoville	IL
Roscoe	IL
Roselle	IL
Rosemont	IL
Roseville	IL
Rossville	IL
Round Lake	IL
Round Lake Beach	IL
Round Lake Heights	IL
Round Lake Park	IL
Rushville	IL
Saint Anne	IL
Saint Charles	IL
Saint Joseph	IL
Sandwich	IL
Sauk Village	IL
Savanna	IL
Savoy	IL
Schaumburg	IL
Schiller Park	IL
Seneca	IL
Sheldon	IL
Sheridan	IL
Shorewood	IL
Sidney	IL
Silvis	IL
Skokie	IL
Sleepy Hollow	IL
Somonauk	IL
South Barrington	IL
South Beloit	IL
South Chicago Heights	IL
South Elgin	IL
South Holland	IL
South Pekin	IL
Spring Grove	IL
Spring Valley	IL
Steger	IL
Sterling	IL
Stickney	IL
Stillman Valley	IL
Stockton	IL
Stone Park	IL
Streamwood	IL
Streator	IL
Sugar Grove	IL
Summit	IL
Sycamore	IL
Third Lake	IL
Thomasboro	IL
Thornton	IL
Tilton	IL
Tinley Park	IL
Toluca	IL
Toulon	IL
Tower Lake	IL
Tremont	IL
University Park	IL
Urbana	IL
Venetian Village	IL
Vernon Hills	IL
Villa Park	IL
Wadsworth	IL
Walnut	IL
Warren	IL
Warrenville	IL
Warsaw	IL
Washburn	IL
Washington	IL
Waterman	IL
Watseka	IL
Wauconda	IL
Waukegan	IL
Wayne	IL
Wenona	IL
West Chicago	IL
West Dundee	IL
West Peoria	IL
Westchester	IL
Western Springs	IL
Westmont	IL
Westville	IL
Wheaton	IL
Wheeling	IL
Willow Springs	IL
Willowbrook	IL
Willowbrook	IL
Wilmette	IL
Wilmington	IL
Winfield	IL
Winnebago	IL
Winnetka	IL
Winthrop Harbor	IL
Wonder Lake	IL
Wood Dale	IL
Woodridge	IL
Woodstock	IL
Worth	IL
Wyoming	IL
Yorkville	IL
Zion	IL
Akron	IN
Albany	IN
Albion	IN
Alexandria	IN
Anderson	IN
Andrews	IN
Angola	IN
Arcadia	IN
Argos	IN
Attica	IN
Auburn	IN
Avilla	IN
Bass Lake	IN
Battle Ground	IN
Berne	IN
Bluffton	IN
Bourbon	IN
Bremen	IN
Bristol	IN
Brookston	IN
Butler	IN
Cedar Lake	IN
Chesterfield	IN
Chesterton	IN
Churubusco	IN
Cicero	IN
Columbia City	IN
Converse	IN
Covington	IN
Crawfordsville	IN
Crown Point	IN
Culver	IN
Dale	IN
Daleville	IN
Dayton	IN
DeMotte	IN
Decatur	IN
Delphi	IN
Dunkirk	IN
Dunkirk	IN
Dyer	IN
Dunlap	IN
East Chicago	IN
Eaton	IN
Edgewood	IN
Elkhart	IN
Elwood	IN
Fairmount	IN
Farmland	IN
Flora	IN
Fort Wayne	IN
Fowler	IN
Frankfort	IN
Fremont	IN
Frankton	IN
Galveston	IN
Garrett	IN
Gary	IN
Gas City	IN
Geneva	IN
Georgetown	IN
Georgetown	IN
Goodland	IN
Goshen	IN
Grabill	IN
Granger	IN
Greentown	IN
Griffith	IN
Gulivoire Park	IN
Hammond	IN
Hartford City	IN
Hebron	IN
Highland	IN
Hobart	IN
Huntertown	IN
Huntington	IN
Indian Heights	IN
Jonesboro	IN
Kendallville	IN
Kentland	IN
Kingsford Heights	IN
Kokomo	IN
Koontz Lake	IN
Kouts	IN
Knox	IN
LaPorte	IN
Lafayette	IN
Lagrange	IN
Lake Dalecarlia	IN
Lake Station	IN
Lakes of the Four Seasons	IN
Lapel	IN
Lebanon	IN
Leo-Cedarville	IN
Ligonier	IN
Logansport	IN
Long Beach	IN
Lowell	IN
Lynn	IN
Marion	IN
Markle	IN
Merrillville	IN
Michigan City	IN
Middlebury	IN
Middletown	IN
Milford	IN
Mishawaka	IN
Monon	IN
Monroeville	IN
Monticello	IN
Montpelier	IN
Morocco	IN
Mount Vernon	IN
Mulberry	IN
Muncie	IN
Munster	IN
Nappanee	IN
New Carlisle	IN
New Chicago	IN
New Haven	IN
Noblesville	IN
North Judson	IN
North Liberty	IN
North Manchester	IN
North Webster	IN
Ogden Dunes	IN
Osceola	IN
Ossian	IN
Otterbein	IN
Oxford	IN
Parker City	IN
Peru	IN
Plymouth	IN
Portage	IN
Porter	IN
Portland	IN
Redkey	IN
Remington	IN
Rensselaer	IN
Roanoke	IN
Rochester	IN
Rome City	IN
Roselawn	IN
Rossville	IN
Russiaville	IN
Saint John	IN
Schererville	IN
Shadeland	IN
Sheridan	IN
Simonton Lake	IN
South Bend	IN
South Haven	IN
South Whitley	IN
Summitville	IN
Syracuse	IN
Thorntown	IN
Tipton	IN
Topeka	IN
Trail Creek	IN
Tri-Lakes	IN
Union City	IN
Upland	IN
Valparaiso	IN
Veedersburg	IN
Wabash	IN
Wakarusa	IN
Walkerton	IN
Walton	IN
Warren	IN
Warsaw	IN
Waterloo	IN
West Lafayette	IN
Westfield	IN
Westville	IN
Whiting	IN
Williamsport	IN
Winamac	IN
Winchester	IN
Winona Lake	IN
Winfield	IN
Woodburn	IN
Yorktown	IN
Abington	MA
Acton	MA
Acushnet	MA
Adams	MA
Agawam	MA
Amesbury	MA
Amherst Center	MA
Andover	MA
Arlington	MA
Ashburnham	MA
Ashby	MA
Ashfield	MA
Ashland	MA
Athol	MA
Attleboro	MA
Auburn	MA
Avon	MA
Ayer	MA
Baldwinville	MA
Barnstable	MA
Barre	MA
Becket	MA
Bedford	MA
Belchertown	MA
Bellingham	MA
Belmont	MA
Berkley	MA
Berlin	MA
Bernardston	MA
Beverly	MA
Beverly Cove	MA
Billerica	MA
Blackstone	MA
Blandford	MA
Bliss Corner	MA
Bolton	MA
Bondsville	MA
Boston	MA
Bourne	MA
Boxford	MA
Boylston	MA
Braintree	MA
Brewster	MA
Bridgewater	MA
Brimfield	MA
Brockton	MA
Brookfield	MA
Brookline	MA
Buckland	MA
Burlington	MA
Buzzards Bay	MA
Cambridge	MA
Canton	MA
Carlisle	MA
Carver	MA
Centerville	MA
Charlemont	MA
Charlton	MA
Chatham	MA
Chelmsford	MA
Chelsea	MA
Cheshire	MA
Chester	MA
Chesterfield	MA
Chicopee	MA
Clinton	MA
Cochituate	MA
Cohasset	MA
Colrain	MA
Concord	MA
Conway	MA
Cordaville	MA
Cotuit	MA
Dalton	MA
Danvers	MA
Dedham	MA
Deerfield	MA
Dennis	MA
Dennis Port	MA
Dighton	MA
Douglas	MA
Dover	MA
Dracut	MA
Dudley	MA
Dunstable	MA
Duxbury	MA
East Bridgewater	MA
East Brookfield	MA
East Dennis	MA
East Douglas	MA
East Harwich	MA
East Longmeadow	MA
East Pepperell	MA
East Sandwich	MA
Eastham	MA
Easthampton	MA
Easton	MA
Erving	MA
Essex	MA
Everett	MA
Fairhaven	MA
Fall River	MA
Falmouth	MA
Fiskdale	MA
Fitchburg	MA
Forestdale	MA
Foxborough	MA
Framingham	MA
Framingham Center	MA
Franklin	MA
Gardner	MA
Gill	MA
Gloucester	MA
Grafton	MA
Granby	MA
Granville	MA
Great Barrington	MA
Greenfield	MA
Groveland	MA
Hadley	MA
Halifax	MA
Hamilton	MA
Hampden	MA
Hanson	MA
Hanover	MA
Hardwick	MA
Harvard	MA
Harwich	MA
Harwich Port	MA
Hatfield	MA
Haverhill	MA
Head of Westport	MA
Hingham	MA
Hinsdale	MA
Holbrook	MA
Holden	MA
Holland	MA
Holliston	MA
Holyoke	MA
Hopedale	MA
Hopkinton	MA
Housatonic	MA
Hubbardston	MA
Hudson	MA
Hull	MA
Huntington	MA
Hyannis	MA
Ipswich	MA
Kingston	MA
Lancaster	MA
Lanesborough	MA
Lawrence	MA
Lee	MA
Leicester	MA
Lenox	MA
Leominster	MA
Leverett	MA
Lexington	MA
Lincoln	MA
Littleton Common	MA
Longmeadow	MA
Lowell	MA
Ludlow	MA
Lunenburg	MA
Lynn	MA
Lynnfield	MA
Malden	MA
Mansfield	MA
Marblehead	MA
Marion	MA
Marlborough	MA
Marshfield	MA
Marshfield Hills	MA
Marstons Mills	MA
Mashpee	MA
Mattapoisett	MA
Maynard	MA
Medfield	MA
Medford	MA
Medway	MA
Melrose	MA
Mendon	MA
Merrimac	MA
Methuen	MA
Middleton	MA
Milford	MA
Millbury	MA
Millers Falls	MA
Millis	MA
Millville	MA
Milton	MA
Monson	MA
Monument Beach	MA
Montague	MA
Nahant	MA
Nantucket	MA
Natick	MA
Needham	MA
New Bedford	MA
New Marlborough	MA
Newburyport	MA
Newton	MA
Norfolk	MA
North Adams	MA
North Amherst	MA
North Brookfield	MA
North Chicopee	MA
North Eastham	MA
North Falmouth	MA
North Lakeville	MA
North Pembroke	MA
North Plymouth	MA
North Reading	MA
North Scituate	MA
North Seekonk	MA
North Westport	MA
Northampton	MA
Northborough	MA
Northbridge	MA
Northfield	MA
Norton	MA
Norwell	MA
Norwood	MA
Oak Bluffs	MA
Oakham	MA
Ocean Grove	MA
Onset	MA
Orange	MA
Orleans	MA
Osterville	MA
Otis	MA
Oxford	MA
Palmer	MA
Paxton	MA
Peabody	MA
Pelham	MA
Pepperell	MA
Petersham	MA
Phillipston	MA
Pinehurst	MA
Pittsfield	MA
Plainville	MA
Plymouth	MA
Plympton	MA
Pocasset	MA
Princeton	MA
Provincetown	MA
Quincy	MA
Randolph	MA
Raynham	MA
Raynham Center	MA
Reading	MA
Rehoboth	MA
Richmond	MA
Rochester	MA
Rockland	MA
Rockport	MA
Rowley	MA
Royalston	MA
Russell	MA
Rutland	MA
Sagamore	MA
Salem	MA
Salisbury	MA
Sandwich	MA
Saugus	MA
Scituate	MA
Seekonk	MA
Sharon	MA
Shelburne	MA
Shelburne Falls	MA
Sherborn	MA
Shirley	MA
Shrewsbury	MA
Shutesbury	MA
Smith Mills	MA
Somerset	MA
Somerville	MA
South Amherst	MA
South Boston	MA
South Deerfield	MA
South Dennis	MA
South Hadley	MA
South Lancaster	MA
South Peabody	MA
South Yarmouth	MA
Southampton	MA
Southborough	MA
Southbridge	MA
Southwick	MA
Spencer	MA
Springfield	MA
Sterling	MA
Stockbridge	MA
Stoneham	MA
Stoughton	MA
Stow	MA
Sturbridge	MA
Sudbury	MA
Sunderland	MA
Sutton	MA
Swampscott	MA
Swansea	MA
Taunton	MA
Teaticket	MA
Templeton	MA
Tewksbury	MA
Topsfield	MA
Townsend	MA
Truro	MA
Turners Falls	MA
Tyngsboro	MA
Upton	MA
Uxbridge	MA
Vineyard Haven	MA
Wakefield	MA
Wales	MA
Walpole	MA
Waltham	MA
Ware	MA
Wareham Center	MA
Warren	MA
Watertown	MA
Wayland	MA
Webster	MA
Wellesley	MA
Wellfleet	MA
Wendell	MA
Wenham	MA
West Boylston	MA
West Bridgewater	MA
West Chatham	MA
West Concord	MA
West Brookfield	MA
West Dennis	MA
West Falmouth	MA
West Newbury	MA
West Springfield	MA
West Stockbridge	MA
West Tisbury	MA
West Wareham	MA
West Yarmouth	MA
Westborough	MA
Westfield	MA
Westford	MA
Westhampton	MA
Westminster	MA
Weston	MA
Westwood	MA
Weweantic	MA
Weymouth	MA
Whately	MA
White Island Shores	MA
Whitinsville	MA
Whitman	MA
Wilbraham	MA
Williamsburg	MA
Williamstown	MA
Wilmington	MA
Winchendon	MA
Winchester	MA
Winthrop	MA
Woburn	MA
Worcester	MA
Wrentham	MA
Yarmouth	MA
Yarmouth Port	MA
Acton	ME
Addison	ME
Albion	ME
Appleton	ME
Arundel	ME
Ashland	ME
Auburn	ME
Augusta	ME
Bangor	ME
Bar Harbor	ME
Bath	ME
Belfast	ME
Belgrade	ME
Benton	ME
Bethel	ME
Biddeford	ME
Blue Hill	ME
Boothbay	ME
Boothbay Harbor	ME
Bowdoinham	ME
Bradford	ME
Bradley	ME
Brewer	ME
Bridgton	ME
Bristol	ME
Brooks	ME
Brownfield	ME
Brownville	ME
Brunswick	ME
Buckfield	ME
Bucksport	ME
Burnham	ME
Buxton	ME
Calais	ME
Camden	ME
Canaan	ME
Canton	ME
Cape Neddick	ME
Caribou	ME
Casco	ME
Castine	ME
Charleston	ME
Chelsea	ME
Cherryfield	ME
Chesterville	ME
China	ME
Chisholm	ME
Clinton	ME
Corinna	ME
Cornish	ME
Cornville	ME
Cumberland Center	ME
Cushing	ME
Damariscotta	ME
Dedham	ME
Deer Isle	ME
Denmark	ME
Dexter	ME
Dixfield	ME
Dixmont	ME
Dover-Foxcroft	ME
East Machias	ME
East Millinocket	ME
Easton	ME
Eastport	ME
Eddington	ME
Edgecomb	ME
Eliot	ME
Ellsworth	ME
Enfield	ME
Etna	ME
Fairfield	ME
Falmouth	ME
Falmouth Foreside	ME
Farmingdale	ME
Farmington	ME
Fayette	ME
Fort Fairfield	ME
Fort Kent	ME
Frankfort	ME
Franklin	ME
Freeport	ME
Friendship	ME
Fryeburg	ME
Gardiner	ME
Garland	ME
Gorham	ME
Gouldsboro	ME
Gray	ME
Greenbush	ME
Greene	ME
Greenville	ME
Hallowell	ME
Hampden	ME
Hancock	ME
Harpswell Center	ME
Harrison	ME
Hartford	ME
Hebron	ME
Hermon	ME
Hiram	ME
Hodgdon	ME
Holden	ME
Hollis Center	ME
Houlton	ME
Howland	ME
Hudson	ME
Jay	ME
Jefferson	ME
Jonesport	ME
Kenduskeag	ME
Kennebunk	ME
Kennebunkport	ME
Kingfield	ME
Kittery Point	ME
Kittery	ME
Lake Arrowhead	ME
Lebanon	ME
Leeds	ME
Levant	ME
Lewiston	ME
Limerick	ME
Limestone	ME
Limington	ME
Lincoln	ME
Lincolnville	ME
Lisbon	ME
Lisbon Falls	ME
Livermore	ME
Livermore Falls	ME
Lovell	ME
Lubec	ME
Machias	ME
Machiasport	ME
Madawaska	ME
Madison	ME
Manchester	ME
Mapleton	ME
Mars Hill	ME
Mechanic Falls	ME
Medway	ME
Mexico	ME
Milbridge	ME
Milford	ME
Millinocket	ME
Milo	ME
Minot	ME
Monmouth	ME
Mount Vernon	ME
Naples	ME
New Gloucester	ME
New Sharon	ME
Newcastle	ME
Newport	ME
Newfield	ME
Nobleboro	ME
Norridgewock	ME
North Bath	ME
North Berwick	ME
North Windham	ME
Northport	ME
Norway	ME
Oakland	ME
Ogunquit	ME
Old Orchard Beach	ME
Old Town	ME
Orland	ME
Orono	ME
Orrington	ME
Owls Head	ME
Oxford	ME
Palermo	ME
Palmyra	ME
Paris	ME
Parsonsfield	ME
Patten	ME
Penobscot	ME
Peru	ME
Phippsburg	ME
Pittsfield	ME
Pittston	ME
Plymouth	ME
Poland	ME
Porter	ME
Portland	ME
Presque Isle	ME
Randolph	ME
Raymond	ME
Readfield	ME
Richmond	ME
Rockport	ME
Rome	ME
Rumford	ME
Sabattus	ME
Saco	ME
Saint Albans	ME
Saint George	ME
Sanford	ME
Sangerville	ME
Scarborough	ME
Searsmont	ME
Searsport	ME
Sedgwick	ME
Shapleigh	ME
Sidney	ME
Skowhegan	ME
South Berwick	ME
South Eliot	ME
South Paris	ME
South Portland	ME
South Portland Gardens	ME
South Sanford	ME
South Thomaston	ME
Southwest Harbor	ME
Springvale	ME
Standish	ME
Stetson	ME
Steuben	ME
Stockton Springs	ME
Stonington	ME
Strong	ME
Sullivan	ME
Surry	ME
Swanville	ME
Thomaston	ME
Topsham	ME
Tremont	ME
Trenton	ME
Troy	ME
Turner	ME
Van Buren	ME
Vassalboro	ME
Veazie	ME
Vinalhaven	ME
Waldoboro	ME
Warren	ME
Washburn	ME
Washington	ME
Waterboro	ME
Waterville	ME
Wayne	ME
Wells Beach Station	ME
West Paris	ME
West Scarborough	ME
Westbrook	ME
Whitefield	ME
Wilton	ME
Windsor	ME
Winslow	ME
Winterport	ME
Winthrop	ME
Wiscasset	ME
Winter Harbor	ME
Woolwich	ME
Yarmouth	ME
York Harbor	ME
Adrian	MI
Albion	MI
Algonac	MI
Allegan	MI
Allen Park	MI
Allendale	MI
Alma	MI
Almont	MI
Alpena	MI
Ann Arbor	MI
Argentine	MI
Armada	MI
Athens	MI
Au Sable	MI
Auburn	MI
Auburn Hills	MI
Bad Axe	MI
Baldwin	MI
Bangor	MI
Baraga	MI
Battle Creek	MI
Bay City	MI
Beaverton	MI
Beecher	MI
Beechwood	MI
Belding	MI
Bellaire	MI
Belleville	MI
Bellevue	MI
Benton Harbor	MI
Benton Heights	MI
Berkley	MI
Berrien Springs	MI
Bessemer	MI
Beverly Hills	MI
Big Rapids	MI
Bingham Farms	MI
Birch Run	MI
Birmingham	MI
Blissfield	MI
Bloomfield Hills	MI
Boyne City	MI
Breckenridge	MI
Bridgeport	MI
Bridgman	MI
Brighton	MI
Bronson	MI
Brooklyn	MI
Brown City	MI
Brownlee Park	MI
Buchanan	MI
Buena Vista	MI
Burt	MI
Burton	MI
Byron Center	MI
Cadillac	MI
Caledonia	MI
Canadian Lakes	MI
Canton	MI
Capac	MI
Carleton	MI
Caro	MI
Carrollton	MI
Carson City	MI
Cass City	MI
Cassopolis	MI
Cedar Springs	MI
Center Line	MI
Central Lake	MI
Centreville	MI
Charlevoix	MI
Charlotte	MI
Cheboygan	MI
Chelsea	MI
Chesaning	MI
Clare	MI
Clarkston	MI
Clawson	MI
Clinton	MI
Clinton	MI
Clio	MI
Coldwater	MI
Coleman	MI
Coloma	MI
Colon	MI
Comstock Park	MI
Concord	MI
Constantine	MI
Coopersville	MI
Corunna	MI
Croswell	MI
Crystal Falls	MI
Cutlerville	MI
Davison	MI
DeWitt	MI
Dearborn	MI
Dearborn Heights	MI
Decatur	MI
Detroit	MI
Detroit Beach	MI
Dexter	MI
Dimondale	MI
Douglas	MI
Dowagiac	MI
Dundee	MI
Durand	MI
East Grand Rapids	MI
East Jordan	MI
East Lansing	MI
East Tawas	MI
Eastpointe	MI
Eastwood	MI
Eaton Rapids	MI
Ecorse	MI
Edgemont Park	MI
Edmore	MI
Edwardsburg	MI
Elk Rapids	MI
Escanaba	MI
Essexville	MI
Evart	MI
Fair Plain	MI
Farmington	MI
Farmington Hills	MI
Fennville	MI
Fenton	MI
Ferndale	MI
Ferrysburg	MI
Flat Rock	MI
Flint	MI
Flushing	MI
Forest Hills	MI
Fowler	MI
Fowlerville	MI
Frankenmuth	MI
Frankfort	MI
Franklin	MI
Fraser	MI
Freeland	MI
Fremont	MI
Fruitport	MI
Galesburg	MI
Garden City	MI
Gaylord	MI
Gibraltar	MI
Gladstone	MI
Gladwin	MI
Goodrich	MI
Grand Blanc	MI
Grand Haven	MI
Grand Ledge	MI
Grand Rapids	MI
Grandville	MI
Grass Lake	MI
Grayling	MI
Greenville	MI
Greilickville	MI
Grosse Ile	MI
Grosse Pointe	MI
Grosse Pointe Farms	MI
Grosse Pointe Park	MI
Grosse Pointe Shores	MI
Grosse Pointe Woods	MI
Gwinn	MI
Hamtramck	MI
Hancock	MI
Harbor Beach	MI
Harbor Springs	MI
Harper Woods	MI
Harrison	MI
Hart	MI
Hartford	MI
Harvey	MI
Haslett	MI
Hastings	MI
Hazel Park	MI
Hemlock	MI
Highland Park	MI
Hillsdale	MI
Holland	MI
Holly	MI
Holt	MI
Homer	MI
Houghton	MI
Houghton Lake	MI
Howard City	MI
Howell	MI
Hubbell	MI
Hudson	MI
Hudsonville	MI
Huntington Woods	MI
Imlay City	MI
Indian River	MI
Ionia	MI
Iron Mountain	MI
Iron River	MI
Ironwood	MI
Ishpeming	MI
Ithaca	MI
Jackson	MI
Jenison	MI
Jonesville	MI
Kalamazoo	MI
Kalkaska	MI
Keego Harbor	MI
Kent City	MI
Kentwood	MI
Kingsford	MI
Kingsley	MI
L'Anse	MI
Laingsburg	MI
Lake Fenton	MI
Lake Linden	MI
Lake Michigan Beach	MI
Lake Odessa	MI
Lake Orion	MI
Lakeview	MI
Lakeview	MI
Lakewood Club	MI
Lambertville	MI
Lansing	MI
Lapeer	MI
Lathrup Village	MI
Laurium	MI
Lawrence	MI
Lawton	MI
Leslie	MI
Lewiston	MI
Lexington	MI
Lincoln Park	MI
Linden	MI
Litchfield	MI
Livonia	MI
Lowell	MI
Ludington	MI
Luna Pier	MI
Madison Heights	MI
Manchester	MI
Manistee	MI
Mancelona	MI
Manistique	MI
Manton	MI
Marcellus	MI
Marine City	MI
Marlette	MI
Marquette	MI
Marshall	MI
Marysville	MI
Mason	MI
Mattawan	MI
Mayville	MI
Melvindale	MI
Memphis	MI
Menominee	MI
Michigan Center	MI
Middleville	MI
Midland	MI
Milan	MI
Milford	MI
Millington	MI
Mio	MI
Monroe	MI
Montague	MI
Montrose	MI
Morenci	MI
Mount Clemens	MI
Mount Morris	MI
Mount Pleasant	MI
Munising	MI
Muskegon	MI
Muskegon Heights	MI
Napoleon	MI
Nashville	MI
Negaunee	MI
New Baltimore	MI
New Buffalo	MI
New Haven	MI
New Haven	MI
Newaygo	MI
Newberry	MI
Niles	MI
North Muskegon	MI
Northview	MI
Northville	MI
Norton Shores	MI
Norway	MI
Novi	MI
Oak Park	MI
Okemos	MI
Olivet	MI
Ontonagon	MI
Orchard Lake	MI
Ortonville	MI
Ossineke	MI
Otsego	MI
Ovid	MI
Owosso	MI
Oxford	MI
Parchment	MI
Paw Paw	MI
Paw Paw Lake	MI
Pearl Beach	MI
Perry	MI
Petersburg	MI
Petoskey	MI
Pigeon	MI
Pinckney	MI
Pinconning	MI
Plainwell	MI
Pleasant Ridge	MI
Plymouth	MI
Pontiac	MI
Port Huron	MI
Portage	MI
Portland	MI
Potterville	MI
Prudenville	MI
Quincy	MI
Quinnesec	MI
Ravenna	MI
Reading	MI
Redford	MI
Reed City	MI
Reese	MI
Richmond	MI
River Rouge	MI
Riverview	MI
Rochester	MI
Rochester Hills	MI
Rockford	MI
Rockwood	MI
Rogers City	MI
Romeo	MI
Romulus	MI
Roosevelt Park	MI
Roscommon	MI
Roseville	MI
Royal Oak	MI
Saginaw	MI
Saint Charles	MI
Saint Helen	MI
Saint Ignace	MI
Saint Johns	MI
Saint Joseph	MI
Saint Louis	MI
Saline	MI
Sandusky	MI
Saranac	MI
Saugatuck	MI
Sault Sainte Marie	MI
Schoolcraft	MI
Scottville	MI
Sebewaing	MI
Shelby	MI
Shelby	MI
Shepherd	MI
Shields	MI
Skidway Lake	MI
South Gull Lake	MI
South Haven	MI
South Lyon	MI
South Monroe	MI
South Rockwood	MI
Southfield	MI
Southgate	MI
Sparta	MI
Spring Arbor	MI
Spring Lake	MI
Springfield	MI
Saint Clair	MI
Saint Clair Shores	MI
Stambaugh	MI
Standish	MI
Stanton	MI
Sterling Heights	MI
Stevensville	MI
Stockbridge	MI
Stony Point	MI
Stony Point	MI
Sturgis	MI
Swartz Creek	MI
Sylvan Lake	MI
Tawas City	MI
Taylor	MI
Tecumseh	MI
Temperance	MI
Three Rivers	MI
Three Oaks	MI
Traverse City	MI
Trenton	MI
Trowbridge Park	MI
Troy	MI
Twin Lake	MI
Union City	MI
Utica	MI
Vandercook Lake	MI
Vassar	MI
Vicksburg	MI
Lake Isabella	MI
Wakefield	MI
Walker	MI
Walled Lake	MI
Warren	MI
Waterford	MI
Watervliet	MI
Waverly	MI
Wayland	MI
Wayne	MI
Webberville	MI
West Branch	MI
West Ishpeming	MI
West Monroe	MI
Westland	MI
Westwood	MI
White Cloud	MI
White Pigeon	MI
Whitehall	MI
Whitmore Lake	MI
Williamston	MI
Wixom	MI
Wolf Lake	MI
Wolverine Lake	MI
Woodhaven	MI
Woodland Beach	MI
Wyandotte	MI
Wyoming	MI
Yale	MI
Ypsilanti	MI
Zeeland	MI
Zilwaukee	MI
Ada	MN
Adrian	MN
Afton	MN
Aitkin	MN
Albany	MN
Albert Lea	MN
Albertville	MN
Alexandria	MN
Andover	MN
Anoka	MN
Annandale	MN
Apple Valley	MN
Appleton	MN
Arden Hills	MN
Arlington	MN
Arnold	MN
Atwater	MN
Aurora	MN
Austin	MN
Avon	MN
Babbitt	MN
Bagley	MN
Barnesville	MN
Baudette	MN
Baxter	MN
Bayport	MN
Becker	MN
Belle Plaine	MN
Bemidji	MN
Benson	MN
Big Lake	MN
Birchwood	MN
Bird Island	MN
Blaine	MN
Blooming Prairie	MN
Bloomington	MN
Blue Earth	MN
Braham	MN
Brainerd	MN
Branch	MN
Breckenridge	MN
Breezy Point	MN
Brooklyn Center	MN
Brooklyn Park	MN
Buffalo	MN
Burnsville	MN
Byron	MN
Caledonia	MN
Cambridge	MN
Canby	MN
Cannon Falls	MN
Carver	MN
Centerville	MN
Champlin	MN
Chanhassen	MN
Chaska	MN
Chatfield	MN
Chisago City	MN
Chisholm	MN
Circle Pines	MN
Clara City	MN
Clearwater	MN
Cloquet	MN
Cohasset	MN
Cokato	MN
Coleraine	MN
Cold Spring	MN
Cologne	MN
Columbia Heights	MN
Coon Rapids	MN
Corcoran	MN
Cottage Grove	MN
Cottonwood	MN
Crookston	MN
Crosby	MN
Cross Lake	MN
Crystal	MN
Dassel	MN
Dawson	MN
Dayton	MN
Deephaven	MN
Delano	MN
Dellwood	MN
Detroit Lakes	MN
Dilworth	MN
Dodge Center	MN
Duluth	MN
Eagan	MN
Eagle Lake	MN
East Bethel	MN
East Grand Forks	MN
East Gull Lake	MN
Eden Prairie	MN
Edina	MN
Elbow Lake	MN
Elk River	MN
Ely	MN
Eveleth	MN
Excelsior	MN
Eyota	MN
Fairfax	MN
Fairmont	MN
Falcon Heights	MN
Faribault	MN
Farmington	MN
Fergus Falls	MN
Foley	MN
Forest Lake	MN
Fosston	MN
Frazee	MN
Fridley	MN
Fulda	MN
Gaylord	MN
Gilbert	MN
Glencoe	MN
Glenwood	MN
Glyndon	MN
Golden Valley	MN
Goodview	MN
Grand Marais	MN
Grand Rapids	MN
Granite Falls	MN
Grant	MN
Greenfield	MN
Hallock	MN
Ham Lake	MN
Hanover	MN
Harmony	MN
Harris	MN
Hastings	MN
Hawley	MN
Hayfield	MN
Hector	MN
Hermantown	MN
Hibbing	MN
Hinckley	MN
Hopkins	MN
Houston	MN
Howard Lake	MN
Hoyt Lakes	MN
Hugo	MN
Hutchinson	MN
Independence	MN
International Falls	MN
Inver Grove Heights	MN
Isanti	MN
Jackson	MN
Janesville	MN
Jordan	MN
Kasson	MN
Keewatin	MN
Kenyon	MN
La Crescent	MN
Lake City	MN
Lake Crystal	MN
Lake Elmo	MN
Zimmerman	MN
Lake Saint Croix Beach	MN
Lake Shore	MN
Lakefield	MN
Lakeland	MN
Lakeville	MN
Lauderdale	MN
Le Center	MN
Le Sueur	MN
Lester Prairie	MN
Lewiston	MN
Lexington	MN
Lindstrom	MN
Lino Lakes	MN
Litchfield	MN
Little Canada	MN
Little Falls	MN
Little Rock	MN
Long Lake	MN
Long Prairie	MN
Lonsdale	MN
Luverne	MN
Madelia	MN
Madison	MN
Mahnomen	MN
Mahtomedi	MN
Mankato	MN
Mantorville	MN
Maple Grove	MN
Maple Lake	MN
Maple Plain	MN
Mapleton	MN
Maplewood	MN
Marshall	MN
Medford	MN
Medina	MN
Melrose	MN
Menahga	MN
Mendota Heights	MN
Milaca	MN
Minneapolis	MN
Minneota	MN
Minnetonka	MN
Minnetonka Mills	MN
Minnetrista	MN
Montevideo	MN
Montgomery	MN
Monticello	MN
Montrose	MN
Moorhead	MN
Moose Lake	MN
Mora	MN
Morris	MN
Morristown	MN
Mound	MN
Mounds View	MN
Mountain Iron	MN
Mountain Lake	MN
New Brighton	MN
New Hope	MN
New London	MN
New Prague	MN
New Richland	MN
New Ulm	MN
New York Mills	MN
Newport	MN
Nicollet	MN
Nisswa	MN
North Branch	MN
North Mankato	MN
North Oaks	MN
North Saint Paul	MN
Northfield	MN
Norwood	MN
Norwood Young America	MN
Oak Grove	MN
Oak Park Heights	MN
Oakdale	MN
Oakport	MN
Olivia	MN
Orono	MN
Ortonville	MN
Osakis	MN
Osseo	MN
Otsego	MN
Owatonna	MN
Park Rapids	MN
Parkers Prairie	MN
Paynesville	MN
Pelican Rapids	MN
Perham	MN
Pierz	MN
Pine City	MN
Pine Island	MN
Pipestone	MN
Plainview	MN
Plymouth	MN
Preston	MN
Princeton	MN
Prior Lake	MN
Proctor	MN
Ramsey	MN
Red Lake	MN
Red Lake Falls	MN
Red Wing	MN
Redby	MN
Redwood Falls	MN
Renville	MN
Rice	MN
Richfield	MN
Richmond	MN
Robbinsdale	MN
Rochester	MN
Rock Creek	MN
Rockford	MN
Rockville	MN
Rogers	MN
Roseau	MN
Rosemount	MN
Roseville	MN
Rush City	MN
Rushford	MN
Saint Anthony	MN
Saint Augusta	MN
Saint Bonifacius	MN
Saint Charles	MN
Saint Cloud	MN
Saint Francis	MN
Saint James	MN
Saint Joseph	MN
Saint Louis Park	MN
Saint Michael	MN
Saint Paul	MN
Saint Paul Park	MN
Saint Peter	MN
Sandstone	MN
Sartell	MN
Sauk Centre	MN
Sauk Rapids	MN
Savage	MN
Shakopee	MN
Sherburn	MN
Shoreview	MN
Shorewood	MN
Silver Bay	MN
Slayton	MN
Sleepy Eye	MN
South Saint Paul	MN
Spicer	MN
Spring Grove	MN
Spring Lake Park	MN
Spring Park	MN
Spring Valley	MN
Springfield	MN
Stacy	MN
Staples	MN
Starbuck	MN
Stewartville	MN
Stillwater	MN
Taylors Falls	MN
Thief River Falls	MN
Tonka Bay	MN
Tracy	MN
Truman	MN
Two Harbors	MN
Tyler	MN
Vadnais Heights	MN
Victoria	MN
Virginia	MN
Wabasha	MN
Waconia	MN
Wadena	MN
Waite Park	MN
Walker	MN
Wanamingo	MN
Warren	MN
Warroad	MN
Waseca	MN
Watertown	MN
Waterville	MN
Wayzata	MN
Wells	MN
West Coon Rapids	MN
West Saint Paul	MN
Wheaton	MN
White Bear Lake	MN
Willmar	MN
Windom	MN
Winnebago	MN
Winona	MN
Winsted	MN
Winthrop	MN
Woodbury	MN
Worthington	MN
Wyoming	MN
Young America	MN
Zumbrota	MN
Albany	MO
Bethany	MO
Canton	MO
Kahoka	MO
Kirksville	MO
La Plata	MO
Maryville	MO
Memphis	MO
Milan	MO
Mound City	MO
Rock Port	MO
Stanberry	MO
Tarkio	MO
Trenton	MO
Unionville	MO
Belcourt	ND
Cando	ND
Carrington	ND
Casselton	ND
Cavalier	ND
Devils Lake	ND
Ellendale	ND
Enderlin	ND
Fargo	ND
Grafton	ND
Grand Forks	ND
Harvey	ND
Hillsboro	ND
Horace	ND
Jamestown	ND
Langdon	ND
Larimore	ND
Lisbon	ND
Mayville	ND
New Rockford	ND
Oakes	ND
Park River	ND
Rolla	ND
Rugby	ND
Valley City	ND
Wahpeton	ND
West Fargo	ND
Wishek	ND
Ainsworth	NE
Albion	NE
Alma	NE
Arlington	NE
Ashland	NE
Atkinson	NE
Auburn	NE
Aurora	NE
Battle Creek	NE
Beatrice	NE
Bellevue	NE
Blair	NE
Bloomfield	NE
Broken Bow	NE
Burwell	NE
Central City	NE
Chalco	NE
Columbus	NE
Cozad	NE
Creighton	NE
Crete	NE
Dakota City	NE
David City	NE
Eagle	NE
Elkhorn	NE
Fairbury	NE
Falls City	NE
Fremont	NE
Friend	NE
Fullerton	NE
Geneva	NE
Gibbon	NE
Grand Island	NE
Gretna	NE
Hartington	NE
Hastings	NE
Hebron	NE
Henderson	NE
Hickman	NE
Holdrege	NE
Kearney	NE
La Vista	NE
Lexington	NE
Lincoln	NE
Louisville	NE
Macy	NE
Madison	NE
Milford	NE
Minden	NE
Nebraska City	NE
Neligh	NE
Norfolk	NE
North Bend	NE
O'Neill	NE
Oakland	NE
Omaha	NE
Ord	NE
Papillion	NE
Pender	NE
Pierce	NE
Plainview	NE
Plattsmouth	NE
Ponca	NE
Ralston	NE
Ravenna	NE
Red Cloud	NE
Saint Paul	NE
Schuyler	NE
Seward	NE
Shelton	NE
South Sioux City	NE
Springfield	NE
Stanton	NE
Stromsburg	NE
Superior	NE
Sutton	NE
Syracuse	NE
Tecumseh	NE
Tekamah	NE
Tilden	NE
Valley	NE
Wahoo	NE
Wakefield	NE
Waverly	NE
Wayne	NE
Weeping Water	NE
West Point	NE
Wilber	NE
Wisner	NE
Wood River	NE
Wymore	NE
York	NE
Yutan	NE
Alexandria	NH
Allenstown Elementary School	NH
Alstead	NH
Alton	NH
Amherst	NH
Andover	NH
Antrim	NH
Ashland	NH
Atkinson	NH
Auburn	NH
Barnstead	NH
Barrington	NH
Bartlett	NH
Bedford	NH
Belmont	NH
Bennington	NH
Berlin	NH
Bethlehem	NH
Boscawen	NH
Bow Bog	NH
Bradford	NH
Brentwood	NH
Bridgewater	NH
Bristol	NH
Brookline	NH
Canaan	NH
Candia	NH
Canterbury	NH
Center Harbor	NH
Charlestown	NH
Chester	NH
Chesterfield	NH
Chichester	NH
Claremont	NH
Colebrook	NH
Concord	NH
Contoocook	NH
Conway	NH
Danbury	NH
Danville	NH
Deering	NH
Deerfield	NH
Derry	NH
Derry Village	NH
Dover	NH
Dublin	NH
Durham	NH
East Concord	NH
East Kingston	NH
East Merrimack	NH
Effingham	NH
Enfield	NH
Epping	NH
Epsom	NH
Exeter	NH
Farmington	NH
Fitzwilliam	NH
Franklin	NH
Freedom	NH
Fremont	NH
Gilford	NH
Gilmanton	NH
Goffstown	NH
Gorham	NH
Grafton	NH
Grantham	NH
Greenfield	NH
Greenland	NH
Greenville	NH
Groveton	NH
Hampstead	NH
Hampton	NH
Hampton Falls	NH
Hancock	NH
Hanover	NH
Harrisville	NH
Haverhill	NH
Henniker	NH
Hill	NH
Hillsboro	NH
Hinsdale	NH
Holderness	NH
Hollis	NH
Hooksett	NH
Hopkinton	NH
Hudson	NH
Jaffrey	NH
Jefferson	NH
Keene	NH
Kensington	NH
Kingston	NH
Laconia	NH
Lancaster	NH
Lebanon	NH
Lee	NH
Lempster	NH
Lincoln	NH
Lisbon	NH
Litchfield	NH
Littleton	NH
Londonderry	NH
Loudon	NH
Lyme	NH
Lyndeborough	NH
Madbury	NH
Madison	NH
Manchester	NH
Marlborough	NH
Mason	NH
Meredith	NH
Merrimack	NH
Milan	NH
Milford	NH
Milton	NH
Mont Vernon	NH
Moultonborough	NH
Nashua	NH
New Boston	NH
New Castle	NH
New Durham	NH
New Ipswich	NH
New London	NH
New Hampton	NH
Newbury	NH
Newfields	NH
Newmarket	NH
Newport	NH
Newton	NH
North Conway	NH
North Hampton	NH
Northfield	NH
Northumberland	NH
Northwood	NH
Nottingham	NH
Orford	NH
Ossipee	NH
Pelham	NH
Pembroke	NH
Peterborough	NH
Pinardville	NH
Pittsfield	NH
Plainfield	NH
Plaistow	NH
Plymouth	NH
Portsmouth	NH
Raymond	NH
Richmond	NH
Rindge	NH
Rochester	NH
Rollinsford	NH
Rumney	NH
Rye	NH
Salem	NH
Salisbury	NH
Sanbornton	NH
Sandown	NH
Sandwich	NH
Seabrook	NH
Somersworth	NH
South Hooksett	NH
Springfield	NH
Strafford	NH
Stratford	NH
Stratham Station	NH
Sunapee	NH
Suncook	NH
Sutton	NH
Swanzey	NH
Tamworth	NH
Temple	NH
Thornton	NH
Tilton	NH
Troy	NH
Tuftonboro	NH
Unity	NH
Wakefield	NH
Walpole	NH
Warner	NH
Weare	NH
Webster	NH
West Swanzey	NH
Westmoreland	NH
Whitefield	NH
Wilmot	NH
Wilton	NH
Winchester	NH
Windham	NH
Wolfeboro	NH
Woodstock	NH
Woodsville	NH
Allendale	NJ
Allentown	NJ
Alpine	NJ
Alpha	NJ
Annandale	NJ
Asbury Park	NJ
Atlantic Highlands	NJ
Avenel	NJ
Avon-by-the-Sea	NJ
Bay Head	NJ
Bayonne	NJ
Beattystown	NJ
Belleville	NJ
Belford	NJ
Belmar	NJ
Belvidere	NJ
Bergenfield	NJ
Berkeley Heights	NJ
Bernardsville	NJ
Beverly	NJ
Bloomfield	NJ
Bloomingdale	NJ
Bloomingdale	NJ
Bogota	NJ
Boonton	NJ
Bordentown	NJ
Bound Brook	NJ
Bradley Beach	NJ
Brass Castle	NJ
Brielle	NJ
Brownville	NJ
Budd Lake	NJ
Burlington	NJ
Butler	NJ
Caldwell	NJ
Califon	NJ
Carlstadt	NJ
Carteret	NJ
Cedar Glen West	NJ
Cedar Grove	NJ
Chatham	NJ
Chester	NJ
Clark	NJ
Clearbrook Park	NJ
Cliffside Park	NJ
Cliffwood Beach	NJ
Clifton	NJ
Clinton	NJ
Closter	NJ
Colonia	NJ
Concordia	NJ
Cranbury	NJ
Crandon Lakes	NJ
Cranford	NJ
Cresskill	NJ
Dayton	NJ
Deal	NJ
Delanco	NJ
Demarest	NJ
Dover	NJ
Dunellen	NJ
Dumont	NJ
East Brunswick	NJ
East Freehold	NJ
East Hanover	NJ
East Newark	NJ
East Orange	NJ
East Rutherford	NJ
Eatontown	NJ
Edgewater Park	NJ
Edison	NJ
Edgewater	NJ
Elizabeth	NJ
Elmwood Park	NJ
Emerson	NJ
Englewood	NJ
Englewood Cliffs	NJ
Englishtown	NJ
Essex Fells	NJ
Ewing	NJ
Fair Haven	NJ
Fair Lawn	NJ
Fairfield	NJ
Fairview	NJ
Fairview	NJ
Fanwood	NJ
Farmingdale	NJ
Florham Park	NJ
Fords	NJ
Flemington	NJ
Fort Dix	NJ
Fort Lee	NJ
Franklin	NJ
Franklin Lakes	NJ
Freehold	NJ
Frenchtown	NJ
Garfield	NJ
Garwood	NJ
Gladstone	NJ
Glen Gardner	NJ
Glen Ridge	NJ
Glen Rock	NJ
Guttenberg	NJ
Hackensack	NJ
Hackettstown	NJ
Hamburg	NJ
Hampton	NJ
Haledon	NJ
Harrington Park	NJ
Harrison	NJ
Hasbrouck Heights	NJ
Haworth	NJ
Hawthorne	NJ
Heathcote	NJ
Helmetta	NJ
High Bridge	NJ
Highland Lake	NJ
Highland Park	NJ
Highlands	NJ
Hightstown	NJ
Hillsdale	NJ
Hillside	NJ
Ho-Ho-Kus	NJ
Hoboken	NJ
Hopatcong	NJ
Hopatcong Hills	NJ
Hopewell	NJ
Irvington	NJ
Iselin	NJ
Jamesburg	NJ
Jersey City	NJ
Keansburg	NJ
Kearny	NJ
Kendall Park	NJ
Kenilworth	NJ
Keyport	NJ
Kingston	NJ
Kinnelon	NJ
Lake Mohawk	NJ
Lake Telemark	NJ
Lakehurst	NJ
Lakewood	NJ
Lambertville	NJ
Laurence Harbor	NJ
Lawrenceville	NJ
Lebanon	NJ
Leisure Knoll	NJ
Leisure Village	NJ
Leisure Village East	NJ
Leonardo	NJ
Leonia	NJ
Lincoln Park	NJ
Lincroft	NJ
Linden	NJ
Little Falls	NJ
Little Ferry	NJ
Little Silver	NJ
Livingston	NJ
Lodi	NJ
Long Branch	NJ
Long Valley	NJ
Lyndhurst	NJ
Madison	NJ
Madison Park	NJ
Manasquan	NJ
Manville	NJ
Maplewood	NJ
Matawan	NJ
Maywood	NJ
Mendham	NJ
Metuchen	NJ
Middlesex	NJ
Midland Park	NJ
Milford	NJ
Milltown	NJ
Monmouth Beach	NJ
Monmouth Junction	NJ
Montclair	NJ
Montvale	NJ
Moonachie	NJ
Morganville	NJ
Morris Plains	NJ
Morristown	NJ
Mount Arlington	NJ
Mountain Lakes	NJ
Mountainside	NJ
Navesink	NJ
Neptune City	NJ
Netcong	NJ
New Brunswick	NJ
New Egypt	NJ
New Milford	NJ
New Providence	NJ
Newark	NJ
Newton	NJ
North Arlington	NJ
North Bergen	NJ
North Caldwell	NJ
North Haledon	NJ
North Middletown	NJ
North Plainfield	NJ
Northfield	NJ
Northvale	NJ
Norwood	NJ
Nutley	NJ
Oakhurst	NJ
Oakland	NJ
Ocean Grove	NJ
Oceanport	NJ
Ogdensburg	NJ
Old Bridge	NJ
Old Tappan	NJ
Oradell	NJ
Orange	NJ
Oxford	NJ
Palisades Park	NJ
Palmyra	NJ
Paramus	NJ
Park Ridge	NJ
Parsippany	NJ
Passaic	NJ
Paterson	NJ
Peapack	NJ
Pennington	NJ
Perth Amboy	NJ
Phillipsburg	NJ
Plainfield	NJ
Plainsboro Center	NJ
Point Pleasant	NJ
Point Pleasant Beach	NJ
Pompton Lakes	NJ
Port Monmouth	NJ
Port Reading	NJ
Princeton	NJ
Princeton Junction	NJ
Princeton Meadows	NJ
Prospect Park	NJ
Prospect Park	NJ
Rahway	NJ
Ramsey	NJ
Ramtown	NJ
Raritan	NJ
Red Bank	NJ
Ridgefield	NJ
Ridgefield Park	NJ
Ridgewood	NJ
Ringwood	NJ
River Edge	NJ
River Vale	NJ
Riverdale	NJ
Riverton	NJ
Rochelle Park	NJ
Rockaway	NJ
Roseland	NJ
Roselle	NJ
Roselle Park	NJ
Rossmoor	NJ
Rumson	NJ
Rutherford	NJ
Saddle River	NJ
Saddle Brook	NJ
Sayreville	NJ
Sayreville Junction	NJ
Scotch Plains	NJ
Sea Bright	NJ
Sea Girt	NJ
Secaucus	NJ
Sewaren	NJ
Shark River Hills	NJ
Shrewsbury	NJ
Society Hill	NJ
Somerset	NJ
Somerville	NJ
South Amboy	NJ
South Belmar	NJ
South Bound Brook	NJ
South Old Bridge	NJ
South Orange	NJ
South Plainfield	NJ
South River	NJ
Spotswood	NJ
Spring Lake	NJ
Spring Lake Heights	NJ
Springfield	NJ
Stanhope	NJ
Strathmore	NJ
Summit	NJ
Sussex	NJ
Teaneck	NJ
Tenafly	NJ
Tinton Falls	NJ
Totowa	NJ
Trenton	NJ
Twin Rivers	NJ
Union	NJ
Union Beach	NJ
Union City	NJ
Upper Saddle River	NJ
Verona	NJ
Victory Gardens	NJ
Vernon Valley	NJ
Waldwick	NJ
Wallington	NJ
Wanaque	NJ
Wanamassa	NJ
Washington	NJ
Watchung	NJ
Wayne	NJ
Weehawken	NJ
West Belmar	NJ
West Caldwell	NJ
West Freehold	NJ
West Long Branch	NJ
West Milford	NJ
West New York	NJ
West Orange	NJ
Woodland Park	NJ
Westfield	NJ
Westville	NJ
Westwood	NJ
Wharton	NJ
White Horse	NJ
White Meadow Lake	NJ
Willingboro	NJ
Wood-Ridge	NJ
Woodbridge	NJ
Woodcliff Lake	NJ
Wyckoff	NJ
Yorketown	NJ
Adams	NY
Adams Center	NY
Addison	NY
Airmont	NY
Akron	NY
Albany	NY
Albertson	NY
Albion	NY
Alden	NY
Alexandria Bay	NY
Alfred	NY
Allegany	NY
Altamont	NY
Altona	NY
Amagansett	NY
Amenia	NY
Amityville	NY
Amsterdam	NY
Andover	NY
Angola on the Lake	NY
Angola	NY
Apalachin	NY
Aquebogue	NY
Arcade	NY
Ardsley	NY
Arlington	NY
Armonk	NY
Athens	NY
Atlantic Beach	NY
Attica	NY
Auburn	NY
Averill Park	NY
Avon	NY
Babylon	NY
Bainbridge	NY
Baiting Hollow	NY
Baldwin	NY
Baldwin Harbor	NY
Baldwinsville	NY
Ballston Spa	NY
Balmville	NY
Bardonia	NY
Barnum Island	NY
Batavia	NY
Bath	NY
Bay Park	NY
Bay Shore	NY
Bay Wood	NY
Bayport	NY
Bayville	NY
Beacon	NY
Bedford	NY
Bellerose	NY
Bellerose Terrace	NY
Bellmore	NY
Bellport	NY
Bergen	NY
Bethpage	NY
Big Flats	NY
Billington Heights	NY
Binghamton	NY
Black River	NY
Blasdell	NY
Blauvelt	NY
Bloomfield	NY
Blue Point	NY
Bohemia	NY
Bolivar	NY
Bolivar	NY
Boonville	NY
Brentwood	NY
Brewerton	NY
Brewster	NY
Brewster Hill	NY
Briarcliff Manor	NY
Bridgehampton	NY
Bridgeport	NY
Bridgeport	NY
Brighton	NY
Brightwaters	NY
Brinckerhoff	NY
Broadalbin	NY
Brockport	NY
Brocton	NY
Bronxville	NY
Brookhaven	NY
Brookville	NY
Brownville	NY
Brownville	NY
Buchanan	NY
Buffalo	NY
Cairo	NY
Calcium	NY
Caledonia	NY
Calverton	NY
Cambridge	NY
Camden	NY
Canajoharie	NY
Canandaigua	NY
Canastota	NY
Canisteo	NY
Canton	NY
Carle Place	NY
Carmel	NY
Carthage	NY
Castile	NY
Castleton-on-Hudson	NY
Catskill	NY
Cattaraugus	NY
Cayuga Heights	NY
Cazenovia	NY
Cedarhurst	NY
Celoron	NY
Center Moriches	NY
Centereach	NY
Centerport	NY
Centerport	NY
Central Islip	NY
Central Square	NY
Central Valley	NY
Champlain	NY
Chappaqua	NY
Chatham	NY
Cheektowaga	NY
Chester	NY
Chestnut Ridge	NY
Chittenango	NY
Churchville	NY
Clarence Center	NY
Clark Mills	NY
Clayton	NY
Clifton Springs	NY
Clinton	NY
Clintondale	NY
Cobleskill	NY
Cohoes	NY
Cold Spring	NY
Cold Spring Harbor	NY
Colonie	NY
Commack	NY
Congers	NY
Constantia	NY
Cooperstown	NY
Copiague	NY
Coram	NY
Corinth	NY
Corning	NY
Cornwall-on-Hudson	NY
Cortland	NY
Country Knolls	NY
Coxsackie	NY
Crompond	NY
Croton-on-Hudson	NY
Crown Heights	NY
Crugers	NY
Cuba	NY
Cumberland Head	NY
Cutchogue	NY
Dannemora	NY
Dansville	NY
Deer Park	NY
Delevan	NY
Delhi	NY
Delmar	NY
Depew	NY
Deposit	NY
Dexter	NY
Dix Hills	NY
Dobbs Ferry	NY
Dolgeville	NY
Dover Plains	NY
Dryden	NY
Dundee	NY
Dunkirk	NY
East Atlantic Beach	NY
East Aurora	NY
East Farmingdale	NY
East Glenville	NY
East Greenbush	NY
East Hampton	NY
East Hills	NY
East Islip	NY
East Ithaca	NY
East Meadow	NY
East Massapequa	NY
East Moriches	NY
East New York	NY
East Northport	NY
East Norwich	NY
East Patchogue	NY
East Quogue	NY
East Rochester	NY
East Rockaway	NY
East Setauket	NY
East Shoreham	NY
East Syracuse	NY
East Williston	NY
Eastchester	NY
Eastport	NY
Eatons Neck	NY
Eden	NY
Eden	NY
Elbridge	NY
Ellenville	NY
Elma Center	NY
Elmira	NY
Elmira Heights	NY
Elmont	NY
Elmsford	NY
Elwood	NY
Endicott	NY
Endwell	NY
Fairmount	NY
Fairport	NY
Fairview	NY
Fairview	NY
Falconer	NY
Farmingdale	NY
Farmingville	NY
Fayetteville	NY
Firthcliffe	NY
Fishkill	NY
Flanders	NY
Floral Park	NY
Florida	NY
Flower Hill	NY
Fort Edward	NY
Fort Montgomery	NY
Fort Plain	NY
Fort Salonga	NY
Frankfort	NY
Franklin Square	NY
Franklinville	NY
Fredonia	NY
Freeport	NY
Frewsburg	NY
Friendship	NY
Fulton	NY
Galeville	NY
Garden City	NY
Garden City Park	NY
Garden City South	NY
Gang Mills	NY
Gardnertown	NY
Gasport	NY
Geneseo	NY
Geneva	NY
Glasco	NY
Glen Cove	NY
Glen Head	NY
Glens Falls	NY
Glenwood Landing	NY
Gloversville	NY
Goldens Bridge	NY
Gordon Heights	NY
Goshen	NY
Gouverneur	NY
Gowanda	NY
Granville	NY
Great Neck	NY
Great Neck Gardens	NY
Great Neck Plaza	NY
Great River	NY
Great Neck Estates	NY
Greece	NY
Green Island	NY
Greene	NY
Greenlawn	NY
Greenport	NY
Greenvale	NY
Greenville	NY
Greenwich	NY
Greenwood Lake	NY
Groton	NY
Hagaman	NY
Halesite	NY
Hamburg	NY
Hamilton	NY
Hampton Bays	NY
Hampton Manor	NY
Hancock	NY
Harbor Isle	NY
Harriman	NY
Harris Hill	NY
Harrison	NY
Hartsdale	NY
Hastings-on-Hudson	NY
Hauppauge	NY
Haverstraw	NY
Haviland	NY
Hawthorne	NY
Head of the Harbor	NY
Hempstead	NY
New Hempstead	NY
Herkimer	NY
Heritage Hills	NY
Herricks	NY
Hewlett	NY
Hewlett Harbor	NY
Hicksville	NY
Highland	NY
Highland Falls	NY
Highland Mills	NY
Hillcrest	NY
Hillside Lake	NY
Hilton	NY
Holbrook	NY
Holcomb	NY
Holland	NY
Holley	NY
Holtsville	NY
Homer	NY
Honeoye Falls	NY
Hoosick Falls	NY
Hopewell Junction	NY
Hornell	NY
Horseheads	NY
Houghton	NY
Hudson	NY
Hudson Falls	NY
Huntington	NY
Huntington Bay	NY
Huntington Station	NY
Hurley	NY
Ilion	NY
Inwood	NY
Inwood	NY
Irondequoit	NY
Irvington	NY
Island Park	NY
Islandia	NY
Islip	NY
Islip Terrace	NY
Ithaca	NY
Jamesport	NY
Jamestown	NY
Jericho	NY
Johnson City	NY
Johnstown	NY
Jordan	NY
Kaser	NY
Keeseville	NY
Kenmore	NY
Kensington	NY
Kerhonkson	NY
Kinderhook	NY
Kings Park	NY
Kings Point	NY
Kingston	NY
Kiryas Joel	NY
Lackawanna	NY
Lake Carmel	NY
Lake Erie Beach	NY
Lake Grove	NY
Lake Katrine	NY
Lake Mohegan	NY
Lake Placid	NY
Lake Ronkonkoma	NY
Lake Success	NY
Lakeland	NY
Lakeview	NY
Lakeview	NY
Lakewood	NY
Lancaster	NY
Lansing	NY
Larchmont	NY
Lattingtown	NY
Laurel	NY
Laurel Hollow	NY
Lawrence	NY
Le Roy	NY
Levittown	NY
Lewiston	NY
Liberty	NY
Lido Beach	NY
Lima	NY
Lincoln Park	NY
Lincolndale	NY
Lindenhurst	NY
Little Falls	NY
Little Valley	NY
Liverpool	NY
Livingston Manor	NY
Livonia	NY
Lloyd Harbor	NY
Lockport	NY
Locust Valley	NY
Long Beach	NY
Lorenz Park	NY
Lowville	NY
Lynbrook	NY
Lyncourt	NY
Lyons	NY
Macedon	NY
Mahopac	NY
Malone	NY
Malverne	NY
Mamaroneck	NY
Manchester	NY
Manhasset	NY
Manhasset Hills	NY
Manlius	NY
Manorhaven	NY
Manorville	NY
Manorville	NY
Marathon	NY
Marcellus	NY
Marlboro	NY
Massapequa	NY
Massapequa Park	NY
Massena	NY
Mastic	NY
Mastic Beach	NY
Mattituck	NY
Mattydale	NY
Maybrook	NY
Mayville	NY
Mechanicstown	NY
Mechanicville	NY
Medford	NY
Medina	NY
Melrose Park	NY
Melville	NY
Menands	NY
Merrick	NY
Mexico	NY
Middle Island	NY
Middleburgh	NY
Middleport	NY
Middleport	NY
Middletown	NY
Millbrook	NY
Miller Place	NY
Milton	NY
Milton	NY
Mineola	NY
Minetto	NY
Minoa	NY
Mohawk	NY
Monroe	NY
Monsey	NY
Montauk	NY
Montebello	NY
Montgomery	NY
Monticello	NY
Montour Falls	NY
Moravia	NY
Moriches	NY
Morrisonville	NY
Morrisville	NY
Mount Ivy	NY
Mount Kisco	NY
Mount Morris	NY
Mount Sinai	NY
Mount Vernon	NY
Munsey Park	NY
Munsons Corners	NY
Myers Corner	NY
Muttontown	NY
Nanuet	NY
Napanoch	NY
Naples	NY
Nassau	NY
Nedrow	NY
Nesconset	NY
New Berlin	NY
New Cassel	NY
New City	NY
New Hartford	NY
New Hyde Park	NY
New Paltz	NY
New Rochelle	NY
New Square	NY
New Windsor	NY
New York City	NY
New York Mills	NY
Newark	NY
Newark Valley	NY
Newburgh	NY
Newfane	NY
Niagara Falls	NY
Niskayuna	NY
Nissequogue	NY
Niverville	NY
Norfolk	NY
North Amityville	NY
North Babylon	NY
North Bay Shore	NY
North Bellmore	NY
North Bellport	NY
North Boston	NY
North Collins	NY
North Gates	NY
North Great River	NY
North Hills	NY
North Lindenhurst	NY
North Massapequa	NY
North Merrick	NY
North New Hyde Park	NY
North Patchogue	NY
North Sea	NY
North Syracuse	NY
North Tonawanda	NY
North Valley Stream	NY
North Wantagh	NY
Northport	NY
Northville	NY
Northwest Harbor	NY
Norwich	NY
Norwood	NY
Noyack	NY
Nunda	NY
Nyack	NY
Oakdale	NY
Oakdale	NY
Oakfield	NY
Oceanside	NY
Ogdensburg	NY
Olcott	NY
Old Bethpage	NY
Old Brookville	NY
Old Field	NY
Old Westbury	NY
Olean	NY
Oneida	NY
Oneonta	NY
Orange Lake	NY
Orangeburg	NY
Orchard Park	NY
Oriskany	NY
Ossining	NY
Oswego	NY
Otisville	NY
Owego	NY
Oxford	NY
Oyster Bay	NY
Oyster Bay Cove	NY
Painted Post	NY
Palenville	NY
Palmyra	NY
Patchogue	NY
Pawling	NY
Peach Lake	NY
Pearl River	NY
Peconic	NY
Peekskill	NY
Pelham	NY
Pelham Manor	NY
Penn Yan	NY
Perry	NY
Peru	NY
Peru	NY
Phelps	NY
Philadelphia	NY
Philmont	NY
Phoenix	NY
Piermont	NY
Pine Bush	NY
Pine Plains	NY
Pittsford	NY
Plainedge	NY
Plainview	NY
Plandome	NY
Plattekill	NY
Plattsburgh	NY
Pleasant Valley	NY
Pleasantville	NY
Poestenkill	NY
Point Lookout	NY
Pomona	NY
Port Byron	NY
Port Chester	NY
Port Dickinson	NY
Port Ewen	NY
Port Henry	NY
Port Jefferson	NY
Port Jefferson Station	NY
Port Jervis	NY
Port Washington	NY
Port Washington North	NY
Potsdam	NY
Poughkeepsie	NY
Pulaski	NY
Putnam Lake	NY
Quogue	NY
Randolph	NY
Ransomville	NY
Rapids	NY
Ravena	NY
Red Hook	NY
Red Oaks Mill	NY
Rensselaer	NY
Rhinebeck	NY
Richfield Springs	NY
Ridge	NY
Riverhead	NY
Riverside	NY
Rochester	NY
Rock Hill	NY
Rockville Centre	NY
Rocky Point	NY
Rome	NY
Ronkonkoma	NY
Roosevelt	NY
Roslyn	NY
Roslyn Estates	NY
Roslyn Harbor	NY
Roslyn Heights	NY
Rotterdam	NY
Rouses Point	NY
Russell Gardens	NY
Rye	NY
Rye Brook	NY
Sackets Harbor	NY
Sag Harbor	NY
Saint James	NY
Saint Johnsville	NY
Salamanca	NY
Salisbury	NY
Sands Point	NY
Saranac Lake	NY
Saratoga Springs	NY
Saugerties	NY
Sayville	NY
Scarsdale	NY
Schenectady	NY
Schoharie	NY
Schuylerville	NY
Scotchtown	NY
Scotia	NY
Scottsville	NY
Sea Cliff	NY
Seaford	NY
Searingtown	NY
Selden	NY
Seneca Falls	NY
Seneca Knolls	NY
Shelter Island	NY
Shenorock	NY
Sherburne	NY
Sherrill	NY
Shinnecock Hills	NY
Shirley	NY
Shokan	NY
Shortsville	NY
Shrub Oak	NY
Sidney	NY
Silver Creek	NY
Skaneateles	NY
Sleepy Hollow	NY
Sloan	NY
Sloatsburg	NY
Smithtown	NY
Sodus	NY
Sodus Point	NY
Solvay	NY
Sound Beach	NY
South Corning	NY
South Fallsburg	NY
South Farmingdale	NY
South Floral Park	NY
South Glens Falls	NY
South Hempstead	NY
South Hill	NY
South Huntington	NY
South Lockport	NY
South Nyack	NY
South Valley Stream	NY
Southampton	NY
Southold	NY
Southport	NY
Spackenkill	NY
Spencerport	NY
Springs	NY
Springville	NY
Spring Valley	NY
Saint Bonaventure	NY
Stamford	NY
Stewart Manor	NY
Stillwater	NY
Stone Ridge	NY
Stony Brook	NY
Stony Point	NY
Stottville	NY
Suffern	NY
Sylvan Beach	NY
Sylvan Beach	NY
Syosset	NY
Syracuse	NY
Tappan	NY
Tarrytown	NY
Terryville	NY
Thiells	NY
Thomaston	NY
Thornwood	NY
Ticonderoga	NY
Tillson	NY
Tivoli	NY
Tonawanda	NY
Town Line	NY
Troy	NY
Trumansburg	NY
Tuckahoe	NY
Tuckahoe	NY
Tupper Lake	NY
Unadilla	NY
Union Springs	NY
Uniondale	NY
University Gardens	NY
Upper Brookville	NY
Upper Nyack	NY
Utica	NY
Vails Gate	NY
Valatie	NY
Valhalla	NY
Valley Cottage	NY
Valley Stream	NY
Vernon	NY
Victor	NY
Village Green	NY
Village of the Branch	NY
Viola	NY
Voorheesville	NY
Wading River	NY
Walden	NY
Wallkill	NY
Walton	NY
Walton Park	NY
Wantagh	NY
Wappingers Falls	NY
Warrensburg	NY
Warsaw	NY
Warwick	NY
Washington Heights	NY
Washingtonville	NY
Waterford	NY
Waterloo	NY
Watermill	NY
Watertown	NY
Waterville	NY
Watkins Glen	NY
Waverly	NY
Webster	NY
Weedsport	NY
Wellsville	NY
Wellsville	NY
Wesley Hills	NY
West Albany	NY
West Babylon	NY
West Bay Shore	NY
West Carthage	NY
West Elmira	NY
West End	NY
West Glens Falls	NY
West Haverstraw	NY
West Hempstead	NY
West Hills	NY
West Hurley	NY
West Islip	NY
West Nyack	NY
West Point	NY
West Sand Lake	NY
West Sayville	NY
West Seneca	NY
Westbury	NY
Westfield	NY
Westhampton	NY
Westhampton Beach	NY
Westmere	NY
Weston Mills	NY
Westons Mills	NY
Westvale	NY
Wheatley Heights	NY
White Plains	NY
Whitehall	NY
Whitesboro	NY
Williamsville	NY
Williston Park	NY
Wilson	NY
Wolcott	NY
Woodbury	NY
Woodmere	NY
Woodridge	NY
Woodstock	NY
Wurtsboro	NY
Wyandanch	NY
Wynantskill	NY
Yaphank	NY
Yonkers	NY
Yorkshire	NY
Yorktown Heights	NY
Yorkville	NY
Youngstown	NY
Zena	NY
Ada	OH
Akron	OH
Alliance	OH
Amherst	OH
Andover	OH
Anna	OH
Ansonia	OH
Antwerp	OH
Archbold	OH
Arlington	OH
Ashland	OH
Ashley	OH
Ashtabula	OH
Aurora	OH
Austintown	OH
Avon	OH
Avon	OH
Avon Lake	OH
Bainbridge	OH
Ballville	OH
Barberton	OH
Bay Village	OH
Beach City	OH
Beachwood	OH
Bedford	OH
Bedford Heights	OH
Beechwood Trails	OH
Bellaire	OH
Bellefontaine	OH
Bellevue	OH
Bellville	OH
Berea	OH
Bethesda	OH
Bluffton	OH
Boardman	OH
Bolindale	OH
Boston Heights	OH
Botkins	OH
Bowling Green	OH
Bradford	OH
Bradner	OH
Bratenahl	OH
Brecksville	OH
Brewster	OH
Bridgeport	OH
Brilliant	OH
Brimfield	OH
Broadview Heights	OH
Brook Park	OH
Brookfield Center	OH
Brooklyn	OH
Brooklyn Heights	OH
Brunswick	OH
Bryan	OH
Bucyrus	OH
Burlington	OH
Burton	OH
Cadiz	OH
Calcutta	OH
Cambridge	OH
Campbell	OH
Canal Fulton	OH
Canfield	OH
Canton	OH
Cardington	OH
Carey	OH
Carrollton	OH
Celina	OH
Centerburg	OH
Chagrin Falls	OH
Chardon	OH
Chesterland	OH
Churchill	OH
Cleveland	OH
Clinton	OH
Clyde	OH
Coldwater	OH
Columbiana	OH
Columbus Grove	OH
Conneaut	OH
Continental	OH
Convoy	OH
Cortland	OH
Coshocton	OH
Covington	OH
Craig Beach	OH
Crestline	OH
Creston	OH
Cridersville	OH
Cuyahoga Falls	OH
Dalton	OH
Danville	OH
De Graff	OH
Defiance	OH
Delaware	OH
Delphos	OH
Delta	OH
Dennison	OH
Deshler	OH
Dover	OH
Doylestown	OH
Dresden	OH
Dublin	OH
East Canton	OH
East Cleveland	OH
East Liverpool	OH
East Palestine	OH
Eastlake	OH
Eaton Estates	OH
Edgerton	OH
Edgewood	OH
Elida	OH
Elmore	OH
Elyria	OH
Euclid	OH
Fairlawn	OH
Fairport Harbor	OH
Fairview Lanes	OH
Fairview Park	OH
Fayette	OH
Findlay	OH
Forest	OH
Fort Loramie	OH
Fort Recovery	OH
Fort Shawnee	OH
Fostoria	OH
Frazeysburg	OH
Fredericktown	OH
Fremont	OH
Gahanna	OH
Galion	OH
Gambier	OH
Garfield Heights	OH
Garrettsville	OH
Gates Mills	OH
Geneva	OH
Geneva-on-the-Lake	OH
Genoa	OH
Gibsonburg	OH
Girard	OH
Glendale	OH
Glenmoor	OH
Gnadenhutten	OH
Grafton	OH
Granville	OH
Green	OH
Green Springs	OH
Greensburg	OH
Greentown	OH
Greenville	OH
Greenwich	OH
Hartville	OH
Heath	OH
Hicksville	OH
Highland Heights	OH
Highland Hills	OH
Hilliard	OH
Hiram	OH
Holgate	OH
Holland	OH
Hopedale	OH
Howland Center	OH
Hubbard	OH
Huber Ridge	OH
Hudson	OH
Huron	OH
Independence	OH
Jackson Center	OH
Jefferson	OH
Johnstown	OH
Kalida	OH
Kent	OH
Kenton	OH
Kirtland	OH
La Croft	OH
Lagrange	OH
Lakemore	OH
Lakeview	OH
Lakewood	OH
Leavittsburg	OH
Leetonia	OH
Leipsic	OH
Lexington	OH
Liberty Center	OH
Lima	OH
Lincoln Heights	OH
Lisbon	OH
Lodi	OH
Lorain	OH
Lordstown	OH
Loudonville	OH
Louisville	OH
Lowellville	OH
Lyndhurst	OH
Macedonia	OH
Madison	OH
Malvern	OH
Manchester	OH
Mansfield	OH
Mantua	OH
Mantua	OH
Maple Heights	OH
Marion	OH
Martins Ferry	OH
Marysville	OH
Massillon	OH
Masury	OH
Maumee	OH
Mayfield	OH
Mayfield Heights	OH
McComb	OH
McDonald	OH
Mechanicsburg	OH
Medina	OH
Mentor	OH
Mentor-on-the-Lake	OH
Middleburg Heights	OH
Middlefield	OH
Milan	OH
Millbury	OH
Millersburg	OH
Mineral Ridge	OH
Minerva	OH
Minerva Park	OH
Mingo Junction	OH
Minster	OH
Mogadore	OH
Monroeville	OH
Montpelier	OH
Moreland Hills	OH
Mount Carmel	OH
Mount Gilead	OH
Mount Vernon	OH
Munroe Falls	OH
Napoleon	OH
Navarre	OH
Neffs	OH
New Albany	OH
New Bremen	OH
New Franklin	OH
New London	OH
New Middletown	OH
New Philadelphia	OH
New Waterford	OH
Newark	OH
Newburgh Heights	OH
Newcomerstown	OH
Newton Falls	OH
Niles	OH
North Baltimore	OH
North Canton	OH
North Kingsville	OH
North Lewisburg	OH
North Madison	OH
North Olmsted	OH
North Ridgeville	OH
North Royalton	OH
Northfield	OH
Northwood	OH
Northwood	OH
Norton	OH
Norwalk	OH
Oak Harbor	OH
Oak Hill	OH
Oakwood	OH
Oberlin	OH
Olmsted Falls	OH
Ontario	OH
Orange	OH
Oregon	OH
Orrville	OH
Orwell	OH
Ottawa	OH
Ottawa Hills	OH
Painesville	OH
Pandora	OH
Parma	OH
Parma Heights	OH
Paulding	OH
Payne	OH
Pemberville	OH
Pepper Pike	OH
Perry	OH
Perry Heights	OH
Perrysburg	OH
Pioneer	OH
Piqua	OH
Plain City	OH
Pleasant Hill	OH
Plymouth	OH
Poland	OH
Port Clinton	OH
Portage Lakes	OH
Powell	OH
Prospect	OH
Ravenna	OH
Reminderville	OH
Richfield	OH
Richmond Heights	OH
Richwood	OH
Rittman	OH
Roaming Shores	OH
Rockford	OH
Rockford	OH
Rocky River	OH
Rossford	OH
Russells Point	OH
Saint Clairsville	OH
Saint Henry	OH
Saint Marys	OH
Saint Paris	OH
Salem	OH
Salineville	OH
Sandusky	OH
Sebring	OH
Seven Hills	OH
Seville	OH
Shaker Heights	OH
Sheffield	OH
Sheffield Lake	OH
Shelby	OH
Sherwood	OH
Shreve	OH
Sidney	OH
Silver Lake	OH
Smithville	OH
Solon	OH
South Amherst	OH
South Canal	OH
South Euclid	OH
South Russell	OH
Spencerville	OH
Steubenville	OH
Stow	OH
Strasburg	OH
Streetsboro	OH
Strongsville	OH
Struthers	OH
Stryker	OH
Sugarcreek	OH
Sunbury	OH
Swanton	OH
Sylvania	OH
Tallmadge	OH
Tiffin	OH
Tiltonsville	OH
Toledo	OH
Toronto	OH
Troy	OH
Twinsburg	OH
Uhrichsville	OH
Union City	OH
Uniontown	OH
University Heights	OH
Upper Sandusky	OH
Urbana	OH
Utica	OH
Valley View	OH
Vermilion	OH
Van Wert	OH
Vermilion-on-the-Lake	OH
Versailles	OH
Wadsworth	OH
Walbridge	OH
Walton Hills	OH
Wapakoneta	OH
Warrensville Heights	OH
Waterville	OH
Warren	OH
Wauseon	OH
Waynesburg	OH
Wellington	OH
Wellsville	OH
West Hill	OH
West Lafayette	OH
West Liberty	OH
West Salem	OH
West Unity	OH
Westerville	OH
Westfield Center	OH
Westlake	OH
Weston	OH
Whitehouse	OH
Wickliffe	OH
Willard	OH
Willoughby	OH
Willoughby Hills	OH
Willowick	OH
Windham	OH
Wintersville	OH
Woodville	OH
Wooster	OH
Worthington	OH
Yorkville	OH
Youngstown	OH
Adamstown	PA
Akron	PA
Albion	PA
Albion	PA
Alburtis	PA
Aliquippa	PA
Allentown	PA
Almedia	PA
Altamont	PA
Altoona	PA
Ambler	PA
Ambridge	PA
Amity Gardens	PA
Ancient Oaks	PA
Annville	PA
Apollo	PA
Archbald	PA
Ardmore	PA
Arlington Heights	PA
Arnold	PA
Ashland	PA
Ashley	PA
Aspinwall	PA
Athens	PA
Audubon	PA
Avalon	PA
Avis	PA
Avoca	PA
Avon	PA
Avonia	PA
Back Mountain	PA
Baden	PA
Baidland	PA
Baldwin	PA
Bally	PA
Bangor	PA
Barnesboro	PA
Bath	PA
Beaver	PA
Beaver Falls	PA
Bedford	PA
Bedminster	PA
Bell Acres	PA
Belfast	PA
Belle Vernon	PA
Bellefonte	PA
Belleville	PA
Bellevue	PA
Bellwood	PA
Belmont	PA
Ben Avon	PA
Bentleyville	PA
Bessemer	PA
Berwick	PA
Bethel Park	PA
Bethlehem	PA
Big Beaver	PA
Birdsboro	PA
Black Lick	PA
Blairsville	PA
Blakely	PA
Blawnox	PA
Bloomfield	PA
Bloomsburg	PA
Blossburg	PA
Blue Bell	PA
Boalsburg	PA
Boiling Springs	PA
Boswell	PA
Boyertown	PA
Brackenridge	PA
Braddock	PA
Braddock Hills	PA
Bradford	PA
Bradford Woods	PA
Brentwood	PA
Brickerville	PA
Bridgeport	PA
Bridgeville	PA
Bristol	PA
Brockway	PA
Brodheadsville	PA
Brookville	PA
Brownsville	PA
Bryn Athyn	PA
Bryn Mawr	PA
Bryn Mawr	PA
Burgettstown	PA
Burnham	PA
Butler	PA
California	PA
Cambridge Springs	PA
Camp Hill	PA
Campbelltown	PA
Canonsburg	PA
Canton	PA
Carbondale	PA
Carlisle	PA
Carrolltown	PA
Castanea	PA
Castle Shannon	PA
Catasauqua	PA
Catawissa	PA
Centerville	PA
Central City	PA
Centre Hall	PA
Chalfont	PA
Charleroi	PA
Chesterbrook	PA
Cheswick	PA
Chevy Chase Heights	PA
Chicora	PA
Churchill	PA
Churchville	PA
Clairton	PA
Clarion	PA
Clarks Green	PA
Clarks Summit	PA
Claysburg	PA
Clearfield	PA
Cleona	PA
Clymer	PA
Coaldale	PA
Cochranton	PA
Collegeville	PA
Colonial Park	PA
Columbia	PA
Colver	PA
Conemaugh	PA
Connellsville	PA
Conshohocken	PA
Conway	PA
Conyngham	PA
Coopersburg	PA
Coplay	PA
Coraopolis	PA
Cornwall	PA
Corry	PA
Coudersport	PA
Crafton	PA
Cresson	PA
Cressona	PA
Croydon	PA
Curtisville	PA
Curwensville	PA
Dale	PA
Dallas	PA
Dalton	PA
Danville	PA
Davidsville	PA
Delmont	PA
Derry	PA
Denver	PA
Dickson City	PA
Dillsburg	PA
Donora	PA
Dormont	PA
Dover	PA
Downingtown	PA
Doylestown	PA
Doylestown	PA
Dravosburg	PA
Du Bois	PA
Dublin	PA
Duboistown	PA
Duncannon	PA
Duncansville	PA
Dunmore	PA
Dunnstown	PA
Dupont	PA
Duquesne	PA
Duryea	PA
Eagleville	PA
East Berwick	PA
East Brady	PA
East Conemaugh	PA
East Greenville	PA
East McKeesport	PA
East Norriton	PA
East Petersburg	PA
East Pittsburgh	PA
East Stroudsburg	PA
East Washington	PA
Eastlawn Gardens	PA
Easton	PA
Ebensburg	PA
Economy	PA
Edgewood	PA
Edgewood	PA
Edgeworth	PA
Edinboro	PA
Edwardsville	PA
Elizabeth	PA
Elim	PA
Elizabethtown	PA
Elizabethville	PA
Elkland	PA
Ellsworth	PA
Ellport	PA
Ellwood City	PA
Elverson	PA
Elysburg	PA
Emigsville	PA
Emmaus	PA
Emporium	PA
Emsworth	PA
Enola	PA
Ephrata	PA
Erie	PA
Espy	PA
Etna	PA
Evans City	PA
Evansburg	PA
Everett	PA
Exeter	PA
Exton	PA
Factoryville	PA
Factoryville	PA
Fairless Hills	PA
Fairview	PA
Farrell	PA
Ferndale	PA
Fernway	PA
Fleetwood	PA
Flemington	PA
Flourtown	PA
Flying Hills	PA
Ford City	PA
Forest City	PA
Forest Hills	PA
Fort Washington	PA
Forty Fort	PA
Fountain Hill	PA
Fox Chapel	PA
Fox Run	PA
Frackville	PA
Franklin	PA
Franklin Park	PA
Fredericksburg	PA
Freedom	PA
Freeland	PA
Freeport	PA
Freemansburg	PA
Friedens	PA
Fullerton	PA
Galeton	PA
Gallitzin	PA
Garden View	PA
Gastonville	PA
Geistown	PA
Gilbertsville	PA
Girard	PA
Girardville	PA
Glassport	PA
Glen Lyon	PA
Glenburn	PA
Glenside	PA
Green Tree	PA
Greenville	PA
Greensburg	PA
Grove City	PA
Halfway House	PA
Hallam	PA
Hallstead	PA
Hamburg	PA
Harleysville	PA
Harrisburg	PA
Harveys Lake	PA
Hastings	PA
Hasson Heights	PA
Hatboro	PA
Hatfield	PA
Hawley	PA
Hazleton	PA
Heidelberg	PA
Hellertown	PA
Hermitage	PA
Hershey	PA
Highland Park	PA
Highspire	PA
Hiller	PA
Hokendauqua	PA
Hollidaysburg	PA
Homer City	PA
Homestead	PA
Hometown	PA
Honesdale	PA
Honey Brook	PA
Horsham	PA
Houserville	PA
Houston	PA
Hughestown	PA
Hughesville	PA
Hummelstown	PA
Huntingdon	PA
Hyde	PA
Indiana	PA
Industry	PA
Ingram	PA
Industry	PA
Irwin	PA
Jeannette	PA
Jefferson Hills	PA
Jenkintown	PA
Jermyn	PA
Jerome	PA
Jersey Shore	PA
Jessup	PA
Jim Thorpe	PA
Johnsonburg	PA
Johnsonburg	PA
Johnstown	PA
Jonestown	PA
Kane	PA
Kenhorst	PA
Kenilworth	PA
King of Prussia	PA
Kingston	PA
Kittanning	PA
Knox	PA
Kulpmont	PA
Kulpsville	PA
Kutztown	PA
Laflin	PA
Lake City	PA
Lake Wynonah	PA
Lancaster	PA
Langhorne	PA
Lansdale	PA
Lansford	PA
Larksville	PA
Latrobe	PA
Laureldale	PA
Lawnton	PA
Lawrence Park	PA
Lawrence Park	PA
Lawson Heights	PA
Lebanon	PA
Leechburg	PA
Leesport	PA
Leetsdale	PA
Lehighton	PA
Lemont	PA
Lemoyne	PA
Lenape Heights	PA
Levittown	PA
Lewisburg	PA
Lewistown	PA
Liberty	PA
Ligonier	PA
Lincoln	PA
Linesville	PA
Linglestown	PA
Linntown	PA
Lititz	PA
Lock Haven	PA
Lorane	PA
Loretto	PA
Lower Allen	PA
Lower Burrell	PA
Luzerne	PA
Lykens	PA
Macungie	PA
Mahanoy City	PA
Malvern	PA
Manchester	PA
Manheim	PA
Manor	PA
Mansfield	PA
Maple Glen	PA
Maple Glen	PA
Marietta	PA
Mars	PA
Marshallton	PA
Martinsburg	PA
Marysville	PA
Matamoras	PA
Matamoras	PA
Mayfield	PA
Mayfield	PA
Maytown	PA
McAdoo	PA
McDonald	PA
McGovern	PA
McKees Rocks	PA
McKeesport	PA
McMurray	PA
Meadowood	PA
Meadville	PA
Mechanicsburg	PA
Mechanicsville	PA
Mercer	PA
Meridian	PA
Middleburg	PA
Middletown	PA
Middletown	PA
Midland	PA
Midland	PA
Mifflinburg	PA
Mifflinville	PA
Milesburg	PA
Milford	PA
Mill Hall	PA
Millersburg	PA
Millvale	PA
Milroy	PA
Milton	PA
Minersville	PA
Mohnton	PA
Monaca	PA
Monessen	PA
Monongahela	PA
Monroeville	PA
Montgomery	PA
Montgomeryville	PA
Montoursville	PA
Montrose	PA
Montrose	PA
Moosic	PA
Morrisville	PA
Moscow	PA
Mount Carmel	PA
Mount Cobb	PA
Mount Holly Springs	PA
Mount Jewett	PA
Mount Joy	PA
Mount Lebanon	PA
Mount Oliver	PA
Mount Penn	PA
Mount Pleasant	PA
Mount Pocono	PA
Mount Union	PA
Mount Wolf	PA
Mountain Top	PA
Mountain Top	PA
Mountainhome	PA
Mountville	PA
Muncy	PA
Munhall	PA
Murrysville	PA
Myerstown	PA
Nanticoke	PA
Nanty Glo	PA
Narberth	PA
Nazareth	PA
Nescopeck	PA
Nesquehoning	PA
New Beaver	PA
New Bloomfield	PA
New Brighton	PA
New Britain	PA
New Castle	PA
New Eagle	PA
New Cumberland	PA
New Hope	PA
New Kensington	PA
New Holland	PA
New Philadelphia	PA
New Stanton	PA
New Wilmington	PA
Newmanstown	PA
Newport	PA
Newtown	PA
Newtown Grant	PA
Newville	PA
Nixon	PA
Norristown	PA
North Apollo	PA
North Belle Vernon	PA
North Braddock	PA
North Charleroi	PA
North Catasauqua	PA
North East	PA
North Versailles	PA
North Wales	PA
Northampton	PA
Northern Cambria	PA
Northumberland	PA
Oak Hills	PA
Oakdale	PA
Oakdale	PA
Oakland	PA
Oakmont	PA
Oakwood	PA
Ohioville	PA
Oil City	PA
Old Forge	PA
Old Orchard	PA
Olyphant	PA
Orchard Hills	PA
Oreland	PA
Orwigsburg	PA
Osceola Mills	PA
Paint	PA
Palmer Heights	PA
Palmerton	PA
Palmyra	PA
Palo Alto	PA
Paoli	PA
Paradise	PA
Park Forest Village	PA
Parkside	PA
Patton	PA
Paxtang	PA
Paxtonia	PA
Pen Argyl	PA
Penbrook	PA
Penn Hills	PA
Penndel	PA
Pennsburg	PA
Perkasie	PA
Perryopolis	PA
Philipsburg	PA
Phoenixville	PA
Pine Grove	PA
Pine Grove Mills	PA
Pitcairn	PA
Pittsburgh	PA
Pittston	PA
Pleasant Gap	PA
Pleasant Hill	PA
Pleasant Hills	PA
Plum	PA
Plymouth	PA
Plymouth Meeting	PA
Plymptonville	PA
Pocono Pines	PA
Polk	PA
Port Carbon	PA
Port Allegany	PA
Port Vue	PA
Portage	PA
Pottsgrove	PA
Pottstown	PA
Pottsville	PA
Progress	PA
Prospect	PA
Punxsutawney	PA
Quakertown	PA
Radnor	PA
Ramblewood	PA
Rankin	PA
Reading	PA
Reamstown	PA
Red Hill	PA
Red Lion	PA
Reiffton	PA
Renovo	PA
Reynoldsville	PA
Rheems	PA
Richboro	PA
Richland	PA
Richlandtown	PA
Ridgway	PA
Riverside	PA
Roaring Spring	PA
Robesonia	PA
Rochester	PA
Rockledge	PA
Roseto	PA
Rothsville	PA
Royersford	PA
Russellton	PA
Rutherford	PA
Saegertown	PA
Saint Clair	PA
Saint Lawrence	PA
Saint Marys	PA
Sanatoga	PA
Sand Hill	PA
Sandy	PA
Saxonburg	PA
Sayre	PA
Schlusser	PA
Schnecksville	PA
Schuylkill Haven	PA
Schwenksville	PA
Scottdale	PA
Scranton	PA
Selinsgrove	PA
Sellersville	PA
Seven Fields	PA
Sewickley	PA
Shamokin	PA
Shamokin Dam	PA
Sharon	PA
Sharpsburg	PA
Sharpsville	PA
Sheffield	PA
Shenandoah	PA
Shenandoah Heights	PA
Shillington	PA
Shiloh	PA
Shinglehouse	PA
Shiremanstown	PA
Shippensburg	PA
Shoemakersville	PA
Sinking Spring	PA
Skippack	PA
Skyline View	PA
Slatington	PA
Slippery Rock	PA
Smethport	PA
Somerset	PA
Souderton	PA
South Fork	PA
South Greensburg	PA
South Pottstown	PA
South Williamsport	PA
Southmont	PA
Southwest Greensburg	PA
Spangler	PA
Speers	PA
Spring City	PA
Spring House	PA
Spring Mount	PA
Springdale	PA
State College	PA
Steelton	PA
Stoneboro	PA
Stormstown	PA
Stowe	PA
Stroudsburg	PA
Sugarcreek	PA
Summit Hill	PA
Sunbury	PA
Susquehanna	PA
Swissvale	PA
Swoyersville	PA
Sykesville	PA
Tamaqua	PA
Tarentum	PA
Tatamy	PA
Taylor	PA
Telford	PA
Temple	PA
Terre Hill	PA
Thompsonville	PA
Throop	PA
Tinicum	PA
Tipton	PA
Titusville	PA
Topton	PA
Towanda	PA
Tower City	PA
Trafford	PA
Trappe	PA
Treasure Lake	PA
Tremont	PA
Trevorton	PA
Trooper	PA
Troy	PA
Troy	PA
Trumbauersville	PA
Tullytown	PA
Tunkhannock	PA
Turtle Creek	PA
Tyrone	PA
Union City	PA
Upper Saint Clair	PA
Valley Green	PA
Valley View	PA
Vandergrift	PA
Verona	PA
Versailles	PA
Village Shires	PA
Vinco	PA
Walnutport	PA
Warminster Heights	PA
Warren	PA
Washington	PA
Waterford	PA
Waterford	PA
Watsontown	PA
Waymart	PA
Weatherly	PA
Wellsboro	PA
Wernersville	PA
Wesleyville	PA
West Brownsville	PA
West Conshohocken	PA
West Easton	PA
West Fairview	PA
West Hazleton	PA
West Hills	PA
West Homestead	PA
West Kittanning	PA
West Lawn	PA
West Leechburg	PA
West Mayfield	PA
West Mifflin	PA
West Newton	PA
West Norriton	PA
West Pittston	PA
West Reading	PA
West View	PA
West Wyoming	PA
West Wyomissing	PA
Westfield	PA
Westmont	PA
Whitaker	PA
White Haven	PA
White Oak	PA
Whitehall	PA
Whitfield	PA
Wilkes-Barre	PA
Wilkinsburg	PA
Williamsburg	PA
Williamsport	PA
Williamstown	PA
Willow Grove	PA
Wilmerding	PA
Wilson	PA
Wilson	PA
Wind Gap	PA
Windber	PA
Wolfdale	PA
Womelsdorf	PA
Woodbourne	PA
Woodland Heights	PA
Woodside	PA
Wormleysburg	PA
Wrightsville	PA
Wyncote	PA
Wyndmoor	PA
Wyoming	PA
Wyomissing	PA
Wyomissing Hills	PA
Yardley	PA
Youngsville	PA
Youngsville	PA
Youngwood	PA
Zelienople	PA
Zion	PA
Ashaway	RI
Barrington	RI
Bradford	RI
Bristol	RI
Central Falls	RI
Charlestown	RI
Coventry	RI
Cranston	RI
Cumberland	RI
Cumberland Hill	RI
East Greenwich	RI
East Providence	RI
Exeter	RI
Foster	RI
Greenville	RI
Harrisville	RI
Hope Valley	RI
Hopkinton	RI
Jamestown	RI
Kingston	RI
Melville	RI
Middletown	RI
Narragansett Pier	RI
Newport	RI
North Kingstown	RI
North Providence	RI
North Scituate	RI
North Smithfield	RI
Pascoag	RI
Pawtucket	RI
Portsmouth	RI
Providence	RI
Smithfield	RI
Tiverton	RI
Valley Falls	RI
Warren	RI
Warwick	RI
West Warwick	RI
Westerly	RI
Woonsocket	RI
Aberdeen	SD
Beresford	SD
Brandon	SD
Britton	SD
Brookings	SD
Canton	SD
Chamberlain	SD
Clark	SD
Clear Lake	SD
Crooks	SD
De Smet	SD
Dell Rapids	SD
Elk Point	SD
Flandreau	SD
Fort Thompson	SD
Freeman	SD
Garretson	SD
Gettysburg	SD
Gregory	SD
Groton	SD
Harrisburg	SD
Hartford	SD
Huron	SD
Lennox	SD
Madison	SD
Milbank	SD
Miller	SD
Mitchell	SD
North Sioux City	SD
Parkston	SD
Platte	SD
Redfield	SD
Salem	SD
Sioux Falls	SD
Sisseton	SD
Tea	SD
Tyndall	SD
Vermillion	SD
Volga	SD
Wagner	SD
Watertown	SD
Webster	SD
Winner	SD
Yankton	SD
Arlington	VT
Barre	VT
Bellows Falls	VT
Bennington	VT
Bethel	VT
Brandon	VT
Brattleboro	VT
Bristol	VT
Burlington	VT
Colchester	VT
Dover	VT
Enosburg Falls	VT
Essex Junction	VT
Fair Haven	VT
Graniteville	VT
Hinesburg	VT
Jericho	VT
Johnson	VT
Lyndon	VT
Lyndonville	VT
Manchester	VT
Middlebury	VT
Milton	VT
Montpelier	VT
Morristown	VT
Morrisville	VT
Newport	VT
North Bennington	VT
Northfield	VT
Poultney	VT
Randolph	VT
Richford	VT
Rockingham	VT
Rutland	VT
Saint Albans	VT
Saint Johnsbury	VT
Shelburne	VT
South Barre	VT
South Burlington	VT
Springfield	VT
Swanton	VT
Vergennes	VT
West Brattleboro	VT
West Rutland	VT
White River Junction	VT
Wilder	VT
Williston	VT
Winooski	VT
Abbotsford	WI
Adams	WI
Albany	WI
Algoma	WI
Allouez	WI
Altoona	WI
Amery	WI
Antigo	WI
Appleton	WI
Arcadia	WI
Ashland	WI
Ashwaubenon	WI
Athens	WI
Augusta	WI
Baldwin	WI
Bangor	WI
Baraboo	WI
Barneveld	WI
Barron	WI
Bayside	WI
Beaver Dam	WI
Belgium	WI
Belleville	WI
Bellevue	WI
Beloit	WI
Benton	WI
Berlin	WI
Big Bend	WI
Black Creek	WI
Black Earth	WI
Black River Falls	WI
Blair	WI
Bloomer	WI
Bohners Lake	WI
Bonduel	WI
Boscobel	WI
Boyceville	WI
Brice Prairie	WI
Brillion	WI
Brodhead	WI
Brookfield	WI
Brooklyn	WI
Brown Deer	WI
Browns Lake	WI
Buffalo City	WI
Burlington	WI
Butler	WI
Cadott	WI
Caledonia	WI
Cambridge	WI
Cameron	WI
Camp Lake	WI
Campbellsport	WI
Cashton	WI
Cassville	WI
Cedar Grove	WI
Cedarburg	WI
Centuria	WI
Chetek	WI
Chilton	WI
Chippewa Falls	WI
Clear Lake	WI
Cleveland	WI
Clinton	WI
Clintonville	WI
Colby	WI
Colfax	WI
Columbus	WI
Combined Locks	WI
Como	WI
Cornell	WI
Cottage Grove	WI
Crandon	WI
Crivitz	WI
Cross Plains	WI
Cuba City	WI
Cudahy	WI
Cumberland	WI
Darien	WI
Darlington	WI
De Forest	WI
De Pere	WI
Deerfield	WI
Delafield	WI
Delavan	WI
Delavan Lake	WI
Denmark	WI
Dickeyville	WI
Dodgeville	WI
Dousman	WI
Durand	WI
Eagle	WI
Eagle Lake	WI
Eagle River	WI
East Troy	WI
Eau Claire	WI
Edgar	WI
Edgerton	WI
Elkhart Lake	WI
Elkhorn	WI
Ellsworth	WI
Elm Grove	WI
Elroy	WI
Evansville	WI
Evergreen	WI
Fall Creek	WI
Fall River	WI
Fennimore	WI
Fitchburg	WI
Fond du Lac	WI
Fontana	WI
Fort Atkinson	WI
Fox Lake	WI
Fox Point	WI
Franklin	WI
Franksville	WI
Frederic	WI
Fredonia	WI
French Island	WI
Galesville	WI
Genoa City	WI
Germantown	WI
Gillett	WI
Glendale	WI
Glenwood City	WI
Grafton	WI
Grantsburg	WI
Green Bay	WI
Green Lake	WI
Greendale	WI
Greenfield	WI
Greenwood	WI
Hales Corners	WI
Hammond	WI
Hartford	WI
Hartland	WI
Hayward	WI
Hazel Green	WI
Hilbert	WI
Hillsboro	WI
Holmen	WI
Horicon	WI
Hortonville	WI
Howard	WI
Howards Grove	WI
Hudson	WI
Hurley	WI
Hustisford	WI
Independence	WI
Iola	WI
Jackson	WI
Janesville	WI
Jefferson	WI
Johnson Creek	WI
Juneau	WI
Kaukauna	WI
Kenosha	WI
Keshena	WI
Kewaskum	WI
Kewaunee	WI
Kiel	WI
Kimberly	WI
Kohler	WI
La Crosse	WI
Lac du Flambeau	WI
Ladysmith	WI
Lake Delton	WI
Lake Geneva	WI
Lake Koshkonong	WI
Lake Mills	WI
Lake Nebagamon	WI
Lake Ripley	WI
Lake Wazeecha	WI
Lake Wisconsin	WI
Lake Wissota	WI
Lancaster	WI
Lannon	WI
Little Chute	WI
Lodi	WI
Lomira	WI
Loyal	WI
Luck	WI
Luxemburg	WI
Madison	WI
Manawa	WI
Manitowoc	WI
Maple Bluff	WI
Marathon	WI
Marinette	WI
Marion	WI
Markesan	WI
Marshall	WI
Marshfield	WI
Mauston	WI
Mayville	WI
Mazomanie	WI
McFarland	WI
Medford	WI
Menasha	WI
Menomonee Falls	WI
Menominee	WI
Mequon	WI
Merrill	WI
Merton	WI
Middleton	WI
Milton	WI
Milwaukee	WI
Mineral Point	WI
Mishicot	WI
Mondovi	WI
Monona	WI
Monroe	WI
Montello	WI
Monticello	WI
Mosinee	WI
Mount Horeb	WI
Mukwonago	WI
Muscoda	WI
Muskego	WI
Nashotah	WI
Neenah	WI
Neillsville	WI
Nekoosa	WI
New Berlin	WI
New Glarus	WI
New Holstein	WI
New Lisbon	WI
New London	WI
New Richmond	WI
Newburg	WI
Niagara	WI
North Fond du Lac	WI
North Hudson	WI
North La Crosse	WI
North Prairie	WI
Oak Creek	WI
Oakfield	WI
Oconomowoc	WI
Oconto	WI
Oconto Falls	WI
Okauchee Lake	WI
Omro	WI
Onalaska	WI
Oneida	WI
Oostburg	WI
Oregon	WI
Orfordville	WI
Osceola	WI
Oshkosh	WI
Osseo	WI
Paddock Lake	WI
Palmyra	WI
Pardeeville	WI
Park Falls	WI
Pell Lake	WI
Peshtigo	WI
Pewaukee	WI
Phillips	WI
Platteville	WI
Pleasant Prairie	WI
Plover	WI
Plymouth	WI
Port Edwards	WI
Port Washington	WI
Portage	WI
Potter Lake	WI
Powers Lake	WI
Poynette	WI
Prairie du Chien	WI
Prairie du Sac	WI
Prescott	WI
Princeton	WI
Pulaski	WI
Racine	WI
Randolph	WI
Random Lake	WI
Redgranite	WI
Reedsburg	WI
Reedsville	WI
Rhinelander	WI
Rib Mountain	WI
Rice Lake	WI
Richfield	WI
Richland Center	WI
Ripon	WI
River Falls	WI
River Hills	WI
Roberts	WI
Rochester	WI
Rothschild	WI
Saint Croix Falls	WI
Saint Francis	WI
Salem	WI
Sauk City	WI
Saukville	WI
Schofield	WI
Seymour	WI
Seymour	WI
Sharon	WI
Shawano	WI
Sheboygan	WI
Sheboygan Falls	WI
Shell Lake	WI
Sherwood	WI
Shorewood	WI
Shorewood Hills	WI
Shullsburg	WI
Silver Lake	WI
Silver Lake	WI
Siren	WI
Slinger	WI
Somers	WI
Somerset	WI
South Milwaukee	WI
Sparta	WI
Spencer	WI
Spooner	WI
Spring Green	WI
Spring Valley	WI
Stanley	WI
Stevens Point	WI
Stoughton	WI
Stratford	WI
Sturgeon Bay	WI
Sturtevant	WI
Suamico	WI
Sun Prairie	WI
Superior	WI
Sussex	WI
Tainter Lake	WI
Theresa	WI
Thiensville	WI
Thorp	WI
Tomah	WI
Tomahawk	WI
Trempealeau	WI
Twin Lakes	WI
Two Rivers	WI
Union Grove	WI
Valders	WI
Verona	WI
Viroqua	WI
Wales	WI
Walworth	WI
Washburn	WI
Waterloo	WI
Waterford	WI
Watertown	WI
Waukesha	WI
Waunakee	WI
Waupaca	WI
Waupun	WI
Wausau	WI
Wautoma	WI
Wauwatosa	WI
West Baraboo	WI
West Allis	WI
West Bend	WI
West Milwaukee	WI
West Salem	WI
Westby	WI
Westfield	WI
Weston	WI
Weyauwega	WI
Whitefish Bay	WI
Whitehall	WI
Whitewater	WI
Whiting	WI
Williams Bay	WI
Wind Lake	WI
Wind Point	WI
Windsor	WI
Winneconne	WI
Wisconsin Dells	WI
Wisconsin Rapids	WI
Wittenberg	WI
Woodville	WI
Wrightstown	WI
Benwood	WV
Bethlehem	WV
Chester	WV
Follansbee	WV
Hooverson Heights	WV
New Cumberland	WV
Newell	WV
Weirton	WV
Weirton Heights	WV
Wellsburg	WV
West Liberty	WV
Wheeling	WV
Newtown	CT
Three Rivers	MA
South Duxbury	MA
Groton	MA
Sheffield	MA
Carmel	ME
Phillips	ME
Kohler	WI
Ansonia	CT
Bethel	CT
Blue Hills	CT
Bridgeport	CT
Bristol	CT
Broad Brook	CT
Branford	CT
Canaan	CT
Canton Valley	CT
Cheshire	CT
Clinton	CT
Colchester	CT
Collinsville	CT
Holbrook	AZ
Fillmore	CA
Bisbee	AZ
Middletown	CA
Black Canyon City	AZ
South Taft	CA
Vine Hill	CA
Dighton	KS
Mona	UT
Buckeye	AZ
Bullhead City	AZ
Bylas	AZ
Cameron	AZ
Camp Verde	AZ
Canyon Day	AZ
Carefree	AZ
Casa Grande	AZ
Casas Adobes	AZ
Catalina	AZ
Catalina Foothills	AZ
Cave Creek	AZ
Chandler	AZ
Chinle	AZ
Chino Valley	AZ
Cibecue	AZ
Clarkdale	AZ
Claypool	AZ
Clifton	AZ
Colorado City	AZ
Congress	AZ
Coolidge	AZ
Cordes Lakes	AZ
Cornville	AZ
Cottonwood	AZ
Desert Hills	AZ
Dilkon	AZ
Dolan Springs	AZ
Douglas	AZ
Drexel Heights	AZ
Dudleyville	AZ
Eagar	AZ
East Sahuarita	AZ
Ehrenberg	AZ
El Mirage	AZ
Eloy	AZ
First Mesa	AZ
Flagstaff	AZ
Florence	AZ
Flowing Wells	AZ
Fort Defiance	AZ
Fortuna Foothills	AZ
Fountain Hills	AZ
Fredonia	AZ
Ganado	AZ
Gila Bend	AZ
Gilbert	AZ
Glendale	AZ
Globe	AZ
Gold Camp	AZ
Golden Valley	AZ
Goodyear	AZ
Grand Canyon Village	AZ
Green Valley	AZ
Guadalupe	AZ
Houck	AZ
Huachuca City	AZ
Kachina Village	AZ
Kaibito	AZ
Kayenta	AZ
Kearny	AZ
Kingman	AZ
Lake Havasu City	AZ
Lake Montezuma	AZ
LeChee	AZ
Leupp	AZ
Litchfield Park	AZ
Littletown	AZ
Lukachukai	AZ
Mammoth	AZ
Many Farms	AZ
Marana	AZ
Maricopa	AZ
Mayer	AZ
Mesa	AZ
Miami	AZ
Mohave Valley	AZ
Morenci	AZ
Mountainaire	AZ
Munds Park	AZ
New River	AZ
Nogales	AZ
Oracle	AZ
Oro Valley	AZ
Page	AZ
Paradise Valley	AZ
Parker	AZ
Parks	AZ
Paulden	AZ
Payson	AZ
Peoria	AZ
Peridot	AZ
Phoenix	AZ
Picture Rocks	AZ
Pima	AZ
Pine	AZ
Pinetop-Lakeside	AZ
Pinon	AZ
Pirtleville	AZ
Prescott	AZ
Prescott Valley	AZ
Quartzsite	AZ
Queen Creek	AZ
Rio Verde	AZ
Sacaton	AZ
Safford	AZ
Sahuarita	AZ
Saint David	AZ
Saint Johns	AZ
Saint Michaels	AZ
Salome	AZ
San Carlos	AZ
San Carlos	AZ
San Luis	AZ
San Manuel	AZ
Scottsdale	AZ
Sedona	AZ
Sehili	AZ
Sells	AZ
Show Low	AZ
Sierra Vista	AZ
Snowflake	AZ
Somerton	AZ
South Tucson	AZ
Spring Valley	AZ
Springerville	AZ
Strawberry	AZ
Summit	AZ
Sun City	AZ
Sun City West	AZ
Sun Lakes	AZ
Sun Valley	AZ
Superior	AZ
Surprise	AZ
Swift Trail Junction	AZ
Tanque Verde	AZ
Taylor	AZ
Teec Nos Pos	AZ
Tempe	AZ
Tempe Junction	AZ
Thatcher	AZ
Three Points	AZ
Tolleson	AZ
Tombstone	AZ
Tortolita	AZ
Tuba City	AZ
Tubac	AZ
Tucson	AZ
Tucson Estates	AZ
Vail	AZ
Wellton	AZ
Whetstone	AZ
Whiteriver	AZ
Wickenburg	AZ
Willcox	AZ
Williams	AZ
Williamson	AZ
Window Rock	AZ
Winslow	AZ
Youngtown	AZ
Yuma	AZ
Acton	CA
Adelanto	CA
Agoura	CA
Agoura Hills	CA
Alameda	CA
Alamo	CA
Albany	CA
Alhambra	CA
Aliso Viejo	CA
Alondra Park	CA
Alpine	CA
Alta Sierra	CA
Alta Sierra	CA
Altadena	CA
Alum Rock	CA
American Canyon	CA
Amesti	CA
Anaheim	CA
Angels Camp	CA
Angwin	CA
Antioch	CA
Apple Valley	CA
Aptos	CA
Arbuckle	CA
Arcadia	CA
Armona	CA
Arnold	CA
Aromas	CA
Arroyo Grande	CA
Artesia	CA
Arvin	CA
Ashland	CA
Atascadero	CA
Atherton	CA
Atwater	CA
Auberry	CA
Auburn	CA
August	CA
Avalon	CA
Avenal	CA
Avocado Heights	CA
Azusa	CA
Bakersfield	CA
Baldwin Park	CA
Banning	CA
Barstow	CA
Barstow Heights	CA
Bay Point	CA
Bear Valley Springs	CA
Beaumont	CA
Bell	CA
Bell Gardens	CA
Bellflower	CA
Belmont	CA
Belvedere	CA
Belvedere	CA
Ben Lomond	CA
Benicia	CA
Berkeley	CA
Bermuda Dunes	CA
Bethel Island	CA
Beverly Hills	CA
Big Bear City	CA
Big Bear Lake	CA
Big Pine	CA
Big River	CA
Biggs	CA
Biola	CA
Bishop	CA
Bloomington	CA
Blythe	CA
Bodega Bay	CA
Bodfish	CA
Bolinas	CA
Bonita	CA
Bonsall	CA
Bootjack	CA
Boron	CA
Boronda	CA
Borrego Springs	CA
Bostonia	CA
Boulder Creek	CA
Boyes Hot Springs	CA
Bradbury	CA
Brawley	CA
Brea	CA
Brentwood	CA
Brisbane	CA
Broadmoor	CA
Buellton	CA
Buena Park	CA
Buena Vista	CA
Burbank	CA
Burbank	CA
Burlingame	CA
Buttonwillow	CA
Bystrom	CA
Cabazon	CA
Calabasas	CA
Calexico	CA
California City	CA
Calipatria	CA
Calistoga	CA
Calimesa	CA
Camarillo	CA
Cambria	CA
Cambrian Park	CA
Cameron Park	CA
Campbell	CA
Canyon Lake	CA
Capitola	CA
Carlsbad	CA
Carmel Valley Village	CA
Carmel-by-the-Sea	CA
Carmichael	CA
Carpinteria	CA
Carson	CA
Caruthers	CA
Casa Conejo	CA
Castro Valley	CA
Castroville	CA
Cathedral City	CA
Cayucos	CA
Ceres	CA
Cerritos	CA
Channel Islands Beach	CA
Charter Oak	CA
Cherry Valley	CA
Cherryland	CA
Chico	CA
China Lake Acres	CA
Chino	CA
Chino Hills	CA
Chowchilla	CA
Chualar	CA
Chula Vista	CA
Citrus	CA
Citrus Heights	CA
Claremont	CA
Clayton	CA
Clearlake	CA
Clearlake Oaks	CA
Cloverdale	CA
Clovis	CA
Coachella	CA
Coalinga	CA
Cobb	CA
Colfax	CA
Colma	CA
Colton	CA
Columbia	CA
Colusa	CA
Commerce	CA
Compton	CA
Concow	CA
Concord	CA
Copperopolis	CA
Corcoran	CA
Corning	CA
Corona	CA
Coronado	CA
Corralitos	CA
Corte Madera	CA
Costa Mesa	CA
Cotati	CA
Coto De Caza	CA
Cottonwood	CA
Country Club	CA
Covelo	CA
Covina	CA
Crest	CA
Crestline	CA
Crockett	CA
Cudahy	CA
Culver City	CA
Cupertino	CA
Cutler	CA
Cypress	CA
Daly City	CA
Dana Point	CA
Danville	CA
Davis	CA
Day Valley	CA
Deer Park	CA
Deer Park	CA
Del Mar	CA
Del Monte Forest	CA
Del Aire	CA
Del Rey Oaks	CA
Del Rio	CA
Delano	CA
Delhi	CA
Denair	CA
Desert Hot Springs	CA
Desert View Highlands	CA
Diablo	CA
Diamond Bar	CA
Diamond Springs	CA
Dinuba	CA
Discovery Bay	CA
Dixon	CA
Dollar Point	CA
Dos Palos	CA
Downey	CA
Duarte	CA
Dublin	CA
Durham	CA
Earlimart	CA
East Compton	CA
East Foothills	CA
East Hemet	CA
East La Mirada	CA
East Los Angeles	CA
East Oakdale	CA
East Palo Alto	CA
East Pasadena	CA
East Porterville	CA
East Quincy	CA
East Richmond Heights	CA
East San Gabriel	CA
East Sonora	CA
Easton	CA
El Cajon	CA
El Centro	CA
El Cerrito	CA
El Cerrito	CA
El Dorado Hills	CA
El Granada	CA
El Monte	CA
El Rio	CA
El Segundo	CA
El Sobrante	CA
El Verano	CA
Eldridge	CA
Elk Grove	CA
Elkhorn	CA
Emerald Lake Hills	CA
Emeryville	CA
Empire	CA
Encinitas	CA
Escalon	CA
Escondido	CA
Esparto	CA
Exeter	CA
Fair Oaks	CA
Fairfax	CA
Fairfield	CA
Fairview	CA
Fallbrook	CA
Farmersville	CA
Felton	CA
Firebaugh	CA
Florin	CA
Folsom	CA
Fontana	CA
Foothill Farms	CA
Foothill Ranch	CA
Ford City	CA
Forest Meadows	CA
Foresthill	CA
Forestville	CA
Fort Bragg	CA
Foster City	CA
Fountain Valley	CA
Fowler	CA
Frazier Park	CA
Freedom	CA
Fremont	CA
French Camp	CA
Fresno	CA
Fullerton	CA
Galt	CA
Garden Acres	CA
Garden Grove	CA
Gardena	CA
Georgetown	CA
Gilroy	CA
Glen Avon	CA
Glendale	CA
Glendora	CA
Gold River	CA
Golden Hills	CA
Goleta	CA
Gonzales	CA
Goshen	CA
Grand Terrace	CA
Granite Bay	CA
Granite Hills	CA
Grass Valley	CA
Graton	CA
Grayson	CA
Green Valley	CA
Greenfield	CA
Gridley	CA
Grover Beach	CA
Guadalupe	CA
Guerneville	CA
Gustine	CA
Hacienda Heights	CA
Half Moon Bay	CA
Hamilton City	CA
Hanford	CA
Harbison Canyon	CA
Hawaiian Gardens	CA
Hawthorne	CA
Hayward	CA
Healdsburg	CA
Heber	CA
Hemet	CA
Hercules	CA
Hermosa Beach	CA
Hesperia	CA
Hidden Hills	CA
Hidden Meadows	CA
Hidden Valley Lake	CA
Highgrove	CA
Highland	CA
Hillsborough	CA
Hollister	CA
Hollywood	CA
Holtville	CA
Home Garden	CA
Home Gardens	CA
Homeland	CA
Hughson	CA
Huntington Beach	CA
Huntington Park	CA
Huron	CA
Imperial	CA
Imperial Beach	CA
Indian Wells	CA
Indian Wells	CA
Indio	CA
Inglewood	CA
Interlaken	CA
Inverness	CA
Inyokern	CA
Ione	CA
Irvine	CA
Irwindale	CA
Isla Vista	CA
Ivanhoe	CA
Jackson	CA
Jamestown	CA
Jamul	CA
Joshua Tree	CA
Julian	CA
Kelseyville	CA
Kennedy	CA
Kensington	CA
Kentfield	CA
Kerman	CA
Kernville	CA
Kettleman City	CA
Keyes	CA
King City	CA
Kings Beach	CA
Kingsburg	CA
La Cañada Flintridge	CA
La Habra	CA
La Habra Heights	CA
La Mesa	CA
La Mirada	CA
La Palma	CA
La Presa	CA
La Puente	CA
La Quinta	CA
La Riviera	CA
La Verne	CA
Ladera Heights	CA
Lafayette	CA
Laguna	CA
Laguna Beach	CA
Laguna Hills	CA
Laguna Niguel	CA
Laguna Woods	CA
Lake Arrowhead	CA
Lake Elsinore	CA
Lake Forest	CA
Lake Isabella	CA
Lake Los Angeles	CA
Lake Nacimiento	CA
Lake San Marcos	CA
Lake Wildwood	CA
Lake of the Pines	CA
Lakeland Village	CA
Lakeport	CA
Lakeside	CA
Lakeview	CA
Lakewood	CA
Lamont	CA
Lancaster	CA
Larkspur	CA
Las Flores	CA
Las Flores	CA
Las Lomas	CA
Lathrop	CA
Laton	CA
Lawndale	CA
Laytonville	CA
Le Grand	CA
Lebec	CA
Lemon Grove	CA
Lemoore	CA
Lennox	CA
Lenwood	CA
Lexington Hills	CA
Lincoln	CA
Lincoln Village	CA
Linda	CA
Linden	CA
Lindsay	CA
Littlerock	CA
Live Oak	CA
Live Oak	CA
Livingston	CA
Livermore	CA
Lockeford	CA
Lodi	CA
Loma Linda	CA
Loma Rica	CA
Lomita	CA
Lompoc	CA
London	CA
Lone Pine	CA
Long Beach	CA
Loomis	CA
Los Alamitos	CA
Los Alamos	CA
Los Altos	CA
Los Altos Hills	CA
Los Angeles	CA
Los Banos	CA
Los Gatos	CA
Los Serranos	CA
Lost Hills	CA
Lower Lake	CA
Loyola	CA
Lucerne	CA
Lucerne	CA
Lynwood	CA
Madera	CA
Madera Acres	CA
Magalia	CA
Malibu	CA
Malibu Beach	CA
Mammoth Lakes	CA
Manhattan Beach	CA
Manteca	CA
Maricopa	CA
Marina	CA
Marina del Rey	CA
Mariposa	CA
Martinez	CA
Marysville	CA
Mayflower Village	CA
Maywood	CA
McFarland	CA
Meadow Vista	CA
Mecca	CA
Meiners Oaks	CA
Mendota	CA
Menlo Park	CA
Mentone	CA
Merced	CA
Mi-Wuk Village	CA
Mill Valley	CA
Millbrae	CA
Milpitas	CA
Mira Loma	CA
Mira Monte	CA
Mission Canyon	CA
Mission Hills	CA
Mission Viejo	CA
Modesto	CA
Mojave	CA
Mono Vista	CA
Monrovia	CA
Montara	CA
Montclair	CA
Monte Rio	CA
Monte Sereno	CA
Montebello	CA
Montecito	CA
Monterey	CA
Monterey Park	CA
Moorpark	CA
Morada	CA
Moraga	CA
Moreno Valley	CA
Morgan Hill	CA
Morongo Valley	CA
Morro Bay	CA
Moss Beach	CA
Mountain Ranch	CA
Mountain View	CA
Mountain View	CA
Mountain View Acres	CA
Murphys	CA
Murrieta	CA
Murrieta Hot Springs	CA
Muscoy	CA
Napa	CA
National City	CA
Needles	CA
Nevada City	CA
Newark	CA
Newman	CA
Newport Beach	CA
Nice	CA
Niland	CA
Nipomo	CA
Norco	CA
North Auburn	CA
North Edwards	CA
North El Monte	CA
North Fair Oaks	CA
North Glendale	CA
North Highlands	CA
Norwalk	CA
Novato	CA
Nuevo	CA
Oak Park	CA
Oak View	CA
Oakdale	CA
Oakhurst	CA
Oakland	CA
Oakley	CA
Occidental	CA
Oceano	CA
Oceanside	CA
Oildale	CA
Ojai	CA
Olivehurst	CA
Ontario	CA
Opal Cliffs	CA
Orange	CA
Orange Cove	CA
Orangevale	CA
Orcutt	CA
Orinda	CA
Orland	CA
Orosi	CA
Oroville	CA
Oxnard	CA
Oxnard Shores	CA
Pacheco	CA
Pacifica	CA
Pacific Grove	CA
Pajaro	CA
Palermo	CA
Palm Desert	CA
Palm Springs	CA
Palmdale	CA
Palo Alto	CA
Palos Verdes Estates	CA
Paradise	CA
Paramount	CA
Parksdale	CA
Parkwood	CA
Parlier	CA
Pasadena	CA
Paso Robles	CA
Patterson	CA
Pedley	CA
Penn Valley	CA
Perris	CA
Petaluma	CA
Pico Rivera	CA
Piedmont	CA
Pine Mountain Club	CA
Pine Valley	CA
Pinole	CA
Piru	CA
Pismo Beach	CA
Pittsburg	CA
Pixley	CA
Placentia	CA
Placerville	CA
Planada	CA
Pleasant Hill	CA
Pleasanton	CA
Plymouth	CA
Pollock Pines	CA
Pomona	CA
Port Hueneme	CA
Portola	CA
Portola Hills	CA
Porterville	CA
Portola Valley	CA
Poway	CA
Prunedale	CA
Quail Valley	CA
Quartz Hill	CA
Quincy	CA
Rainbow	CA
Ramona	CA
Rancho Calaveras	CA
Rancho Cordova	CA
Rancho Cucamonga	CA
Rancho Mirage	CA
Rancho Murieta	CA
Rancho Palos Verdes	CA
Rancho San Diego	CA
Rancho Santa Fe	CA
Rancho Santa Margarita	CA
Redlands	CA
Redondo Beach	CA
Redwood City	CA
Reedley	CA
Rialto	CA
Richgrove	CA
Richmond	CA
Ridgecrest	CA
Ridgemark	CA
Rio Del Mar	CA
Rio Linda	CA
Rio Vista	CA
Ripon	CA
Riverbank	CA
Riverdale	CA
Riverdale Park	CA
Riverside	CA
Rocklin	CA
Rodeo	CA
Rohnert Park	CA
Rolling Hills	CA
Rolling Hills Estates	CA
Rollingwood	CA
Romoland	CA
Rosamond	CA
Rosedale	CA
Roseland	CA
Rosemead	CA
Rosemont	CA
Roseville	CA
Ross	CA
Rossmoor	CA
Rowland Heights	CA
Rubidoux	CA
Running Springs	CA
Sacramento	CA
Saint Helena	CA
Salida	CA
Salinas	CA
Salton City	CA
San Andreas	CA
San Anselmo	CA
San Antonio Heights	CA
San Bernardino	CA
San Bruno	CA
San Carlos	CA
San Clemente	CA
San Diego	CA
San Diego Country Estates	CA
San Dimas	CA
San Fernando	CA
San Francisco	CA
San Gabriel	CA
San Jacinto	CA
San Joaquin	CA
San Joaquin Hills	CA
San Jose	CA
San Juan Bautista	CA
San Juan Capistrano	CA
San Leandro	CA
San Lorenzo	CA
San Luis Obispo	CA
San Marcos	CA
San Marino	CA
San Martin	CA
San Mateo	CA
San Miguel	CA
San Pablo	CA
San Rafael	CA
San Ramon	CA
Sanger	CA
Santa Ana	CA
Santa Barbara	CA
Santa Clara	CA
Santa Clarita	CA
Santa Cruz	CA
Santa Fe Springs	CA
Santa Maria	CA
Santa Monica	CA
Santa Paula	CA
Santa Rosa	CA
Santa Venetia	CA
Santa Ynez	CA
Santee	CA
Saratoga	CA
Sausalito	CA
Scotts Valley	CA
Seal Beach	CA
Searles Valley	CA
Seaside	CA
Sebastopol	CA
Sedco Hills	CA
Seeley	CA
Selma	CA
Seven Trees	CA
Shackelford	CA
Shafter	CA
Shandon	CA
Shingle Springs	CA
Sierra Madre	CA
Signal Hill	CA
Simi Valley	CA
Solana Beach	CA
Soledad	CA
Solvang	CA
Sonoma	CA
Sonora	CA
Soquel	CA
Soulsbyville	CA
South Dos Palos	CA
South El Monte	CA
South Gate	CA
South Lake Tahoe	CA
South Oroville	CA
South Pasadena	CA
South San Francisco	CA
South San Gabriel	CA
South San Jose Hills	CA
South Whittier	CA
South Yuba City	CA
Spring Valley	CA
Springville	CA
Squaw Valley	CA
Stallion Springs	CA
Stanford	CA
Stanton	CA
Stockton	CA
Stratford	CA
Strathmore	CA
Strawberry	CA
Strawberry	CA
Suisun	CA
Summerland	CA
Sun City	CA
Sunnyslope	CA
Sunnyvale	CA
Sunol	CA
Sutter	CA
Sutter Creek	CA
Taft	CA
Taft Heights	CA
Tahoe Vista	CA
Talmage	CA
Tara Hills	CA
Tehachapi	CA
Temecula	CA
Temelec	CA
Temple City	CA
Templeton	CA
Terra Bella	CA
Thermalito	CA
Thousand Oaks	CA
Thousand Palms	CA
Tiburon	CA
Tierra Buena	CA
Tipton	CA
Toro Canyon	CA
Torrance	CA
Trabuco Canyon	CA
Tracy	CA
Truckee	CA
Tulare	CA
Tuolumne City	CA
Turlock	CA
Tustin	CA
North Tustin	CA
Twain Harte	CA
Twentynine Palms	CA
Twin Lakes	CA
Ukiah	CA
Union City	CA
Union City	CA
Upland	CA
Upper Lake	CA
Vacaville	CA
Val Verde	CA
Valinda	CA
Valle Vista	CA
Vallejo	CA
Valley Center	CA
Valley Springs	CA
Vandenberg Village	CA
Ventura	CA
Victorville	CA
Villa Park	CA
Vincent	CA
Visalia	CA
Vista	CA
Waldon	CA
Walnut	CA
Walnut Creek	CA
Walnut Park	CA
Waterford	CA
Watsonville	CA
Weldon	CA
West Athens	CA
West Carson	CA
West Compton	CA
West Covina	CA
West Hollywood	CA
West Menlo Park	CA
West Puente Valley	CA
West Sacramento	CA
Westlake Village	CA
Westminster	CA
Westmont	CA
Westmorland	CA
Westwood	CA
Wheatland	CA
Whittier	CA
Wildomar	CA
Williams	CA
Willits	CA
Willowbrook	CA
Willows	CA
Wilton	CA
Winchester	CA
Windsor	CA
Winters	CA
Winter Gardens	CA
Winton	CA
Wofford Heights	CA
Woodacre	CA
Woodcrest	CA
Woodlake	CA
Woodland	CA
Woodside	CA
Woodville	CA
Wrightwood	CA
Yorba Linda	CA
Yosemite Lakes	CA
Yountville	CA
Yuba City	CA
Yucaipa	CA
Yucca Valley	CA
Acres Green	CO
Alamosa	CO
Applewood	CO
Arvada	CO
Aspen	CO
Aurora	CO
Avon	CO
Basalt	CO
Battlement Mesa	CO
Bayfield	CO
Bennett	CO
Berkley	CO
Beulah Valley	CO
Black Forest	CO
Breckenridge	CO
Brighton	CO
Broomfield	CO
Buena Vista	CO
Burlington	CO
Byers	CO
Cañon City	CO
Carbondale	CO
Carriage Club	CO
Castle Pines	CO
Castle Rock	CO
Castlewood	CO
Cedaredge	CO
Centennial	CO
Center	CO
Cherry Hills Village	CO
Cimarron Hills	CO
Clifton	CO
Coal Creek	CO
Colorado City	CO
Colorado Springs	CO
Columbine	CO
Columbine Valley	CO
Commerce City	CO
Cortez	CO
Crested Butte	CO
Cripple Creek	CO
Del Norte	CO
Delta	CO
Denver	CO
Derby	CO
Durango	CO
Eagle	CO
Edgewater	CO
Edwards	CO
El Jebel	CO
Elizabeth	CO
Englewood	CO
Evergreen	CO
Federal Heights	CO
Florence	CO
Fort Carson	CO
Fountain	CO
Fowler	CO
Frisco	CO
Fruita	CO
Fruitvale	CO
Genesee	CO
Georgetown	CO
Glendale	CO
Gleneagle	CO
Glenwood Springs	CO
Golden	CO
Grand Junction	CO
Greenwood Village	CO
Gunnison	CO
Gypsum	CO
Highlands Ranch	CO
Holly	CO
Hotchkiss	CO
Idaho Springs	CO
Indian Hills	CO
Ken Caryl	CO
Kittredge	CO
La Junta	CO
Lafayette	CO
Lakewood	CO
Lamar	CO
Las Animas	CO
Leadville	CO
Limon	CO
Lincoln Park	CO
Littleton	CO
Lone Tree	CO
Louisville	CO
Mancos	CO
Manitou Springs	CO
Minturn	CO
Monte Vista	CO
Montrose	CO
Monument	CO
Mountain Village	CO
Nederland	CO
New Castle	CO
Northglenn	CO
Olathe	CO
Orchard Mesa	CO
Orchard City	CO
Ordway	CO
Pagosa Springs	CO
Palisade	CO
Palmer Lake	CO
Parachute	CO
Parker	CO
Penrose	CO
Perry Park	CO
Ponderosa Park	CO
Pueblo	CO
Pueblo West	CO
Redlands	CO
Rifle	CO
Rocky Ford	CO
Roxborough Park	CO
Salida	CO
Sheridan	CO
Sherrelwood	CO
Silt	CO
Silverthorne	CO
Snowmass Village	CO
Southglenn	CO
Springfield	CO
Stonegate	CO
Strasburg	CO
Stratmoor	CO
Superior	CO
Telluride	CO
The Pinery	CO
Thornton	CO
Todd Creek	CO
Towaoc	CO
Trinidad	CO
Twin Lakes	CO
Vail	CO
Walsenburg	CO
Welby	CO
Westminster	CO
Wheat Ridge	CO
Woodland Park	CO
Woodmoor	CO
Atwood	KS
Colby	KS
Dodge City	KS
Elkhart	KS
Garden City	KS
Goodland	KS
Holcomb	KS
Hoxie	KS
Hugoton	KS
Johnson	KS
Lakin	KS
Leoti	KS
Liberal	KS
Meade	KS
Oakley	KS
Oberlin	KS
Plains	KS
Saint Francis	KS
Satanta	KS
Scott City	KS
Syracuse	KS
Sublette	KS
Ulysses	KS
Agua Fria	NM
Alamo	NM
Alamogordo	NM
Albuquerque	NM
Anthony	NM
Artesia	NM
Aztec	NM
Bayard	NM
Belen	NM
Bernalillo	NM
Black Rock	NM
Bloomfield	NM
Boles Acres	NM
Bosque Farms	NM
Capitan	NM
Carlsbad	NM
Carrizozo	NM
Cedar Crest	NM
Chama	NM
Chimayo	NM
Church Rock	NM
Clayton	NM
Clovis	NM
Columbus	NM
Corrales	NM
Crownpoint	NM
Deming	NM
Dexter	NM
Doña Ana	NM
Dulce	NM
Edgewood	NM
El Valle de Arroyo Seco	NM
Eldorado at Santa Fe	NM
Elephant Butte	NM
Espanola	NM
Estancia	NM
Eunice	NM
Farmington	NM
Flora Vista	NM
Fort Sumner	NM
Gallup	NM
Grants	NM
Hagerman	NM
Hatch	NM
Hobbs	NM
Hurley	NM
Jal	NM
Jarales	NM
Jemez Pueblo	NM
Kirtland	NM
La Cienega	NM
La Luz	NM
La Puebla	NM
Las Cruces	NM
Las Vegas	NM
Logan	NM
Lordsburg	NM
Los Alamos	NM
Los Chaves	NM
Los Lunas	NM
Los Ranchos de Albuquerque	NM
Loving	NM
Lovington	NM
Meadow Lake	NM
Mescalero	NM
Mesilla	NM
Milan	NM
Moriarty	NM
Mountainair	NM
Navajo	NM
Navajo	NM
North Valley	NM
Pecos	NM
Peralta	NM
Placitas	NM
Portales	NM
Questa	NM
Radium Springs	NM
Ranchos de Taos	NM
Raton	NM
Rio Rancho	NM
Roswell	NM
Ruidoso	NM
Ruidoso Downs	NM
San Felipe Pueblo	NM
Santa Clara	NM
Santa Fe	NM
Santa Rosa	NM
Santa Teresa	NM
Santa Teresa	NM
Santo Domingo Pueblo	NM
Shiprock	NM
Silver City	NM
Socorro	NM
South Valley	NM
Springer	NM
Sunland Park	NM
Taos Pueblo	NM
Taos	NM
Texico	NM
Thoreau	NM
Tohatchi	NM
Truth or Consequences	NM
Tucumcari	NM
Tularosa	NM
Twin Lakes	NM
University Park	NM
Upper Fruitland	NM
Vado	NM
Valencia	NM
White Rock	NM
White Sands	NM
Zuni Pueblo	NM
Boulder City	NV
Bunkerville	NV
Caliente	NV
Carson City	NV
Cold Springs	NV
Dayton	NV
Ely	NV
Enterprise	NV
Fallon	NV
Fernley	NV
Gardnerville	NV
Gardnerville Ranchos	NV
Hawthorne	NV
Henderson	NV
Indian Springs	NV
Johnson Lane	NV
Kingsbury	NV
Las Vegas	NV
Laughlin	NV
McGill	NV
Mesquite	NV
Minden	NV
Moapa Town	NV
Moapa Valley	NV
North Las Vegas	NV
Pahrump	NV
Paradise	NV
Reno	NV
Sandy Valley	NV
Silver Springs	NV
Smith	NV
Spanish Springs	NV
Sparks	NV
Spring Valley	NV
Stateline	NV
Sun Valley	NV
Sunrise Manor	NV
Tonopah	NV
Whitney	NV
Winchester	NV
Yerington	NV
Beaver	OK
Boise City	OK
Goodwell	OK
Guymon	OK
Hooker	OK
Abernathy	TX
Alpine	TX
Amarillo	TX
Andrews	TX
Anthony	TX
Big Lake	TX
Big Spring	TX
Booker	TX
Borger	TX
Bovina	TX
Brackettville	TX
Brownfield	TX
Cactus	TX
Canadian	TX
Canutillo	TX
Canyon	TX
Childress	TX
Cienegas Terrace	TX
Clarendon	TX
Claude	TX
Colorado City	TX
Crane	TX
Crosbyton	TX
Dalhart	TX
Del Rio	TX
Denver City	TX
Dimmitt	TX
Dumas	TX
Eagle Pass	TX
Earth, TX	TX
Eidson Road	TX
El Paso	TX
Eldorado	TX
Elm Creek	TX
Fabens	TX
Farwell	TX
Floydada	TX
Fort Davis	TX
Fort Hancock	TX
Fort Stockton	TX
Friona	TX
Fritch	TX
Gardendale	TX
Grape Creek	TX
Hale Center	TX
Hamlin	TX
Hart	TX
Hereford	TX
Homestead Meadows North	TX
Homestead Meadows South	TX
Horizon City	TX
Idalou	TX
Iraan	TX
Kermit	TX
Lamesa	TX
Las Quintas Fronterizas	TX
Levelland	TX
Littlefield	TX
Lockney	TX
Lorenzo	TX
Lubbock	TX
Marfa	TX
McCamey	TX
Memphis	TX
Merkel	TX
Midland	TX
Monahans	TX
Morton	TX
Muleshoe	TX
O'Donnell	TX
Odessa	TX
Olton	TX
Ozona	TX
Paducah	TX
Pampa	TX
Panhandle	TX
Pecos	TX
Perryton	TX
Petersburg	TX
Plains	TX
Plainview	TX
Post	TX
Presidio	TX
Ransom Canyon	TX
Robert Lee	TX
Rocksprings	TX
Roscoe	TX
Rosita North	TX
Rosita South	TX
Rotan	TX
San Angelo	TX
San Elizario	TX
Seagraves	TX
Seminole	TX
Seth Ward	TX
Shallowater	TX
Shamrock	TX
Slaton	TX
Snyder	TX
Socorro	TX
Socorro Mission Number 1 Colonia	TX
Sonora	TX
Sparks	TX
Spearman	TX
Stanton	TX
Sterling City	TX
Stinnett	TX
Stratford	TX
Sudan	TX
Sundown	TX
Sunray	TX
Sweetwater	TX
Tahoka	TX
Tornillo	TX
Tulia	TX
Val Verde Park	TX
Van Horn	TX
Vinton	TX
Wellington	TX
West Odessa	TX
Westway	TX
Wheeler	TX
White Deer	TX
Wolfforth	TX
Beaver	UT
Blanding	UT
Castle Dale	UT
Cedar City	UT
Delta	UT
East Carbon City	UT
Enoch	UT
Ephraim	UT
Enterprise	UT
Fairview	UT
Ferron	UT
Fillmore	UT
Gunnison	UT
Helper	UT
Hildale	UT
Huntington	UT
Hurricane	UT
Ivins	UT
Kanab	UT
LaVerkin	UT
Manti	UT
Milford	UT
Moab	UT
Monroe	UT
Monticello	UT
Moroni	UT
Mount Pleasant	UT
Nephi	UT
Orangeville	UT
Panguitch	UT
Parowan	UT
Price	UT
Richfield	UT
Saint George	UT
Salina	UT
Santa Clara	UT
Santaquin	UT
Toquerville	UT
Washington	UT
Wellington	UT
Gadsden	AZ
West Sedona	AZ
Three Rivers	CA
Wasco	CA
West Bishop	CA
Paonia	CO
Cimarron	KS
Pojoaque	NM
Beatty	NV
Indian Hills	NV
Anton	TX
Gruver	TX
Ralls	TX
Spur	TX
Centerfield	UT
Ajo	AZ
Apache Junction	AZ
Arizona City	AZ
Avondale	AZ
Avra Valley	AZ
Bagdad	AZ
Benson	AZ
Big Park	AZ
Wray	CO
Rathdrum	ID
Juneau	AK
Beach	ND
Ketchikan	AK
Little Cottonwood Creek Valley	UT
Salem	UT
Wellsville	UT
Lea Hill	WA
Metlakatla	AK
Petersburg	AK
Sitka	AK
Wrangell	AK
Alturas	CA
Anderson	CA
Arcata	CA
Bayview	CA
Blue Lake	CA
Burney	CA
Central Valley (historical)	CA
Chester	CA
Cottonwood	CA
Crescent City	CA
Cutten	CA
Dunsmuir	CA
Eureka	CA
Ferndale	CA
Fortuna	CA
Greenville	CA
Hayfork	CA
Humboldt Hill	CA
Hydesville	CA
Lewiston	CA
Los Molinos	CA
McCloud	CA
McKinleyville	CA
Montague	CA
Mount Shasta	CA
Myrtletown	CA
Palo Cedro	CA
Pine Hills	CA
Red Bluff	CA
Redding	CA
Redway	CA
Rio Dell	CA
Shasta Lake	CA
Shingletown	CA
Susanville	CA
Tulelake	CA
Weaverville	CA
Weed	CA
Westwood	CA
Willow Creek	CA
Yreka	CA
Akron	CO
Aristocrat Ranchettes	CO
Ault	CO
Berthoud	CO
Boulder	CO
Brush	CO
Campion	CO
Craig	CO
Dacono	CO
Eaton	CO
Erie	CO
Estes Park	CO
Evans	CO
Firestone	CO
Fort Collins	CO
Fort Lupton	CO
Fort Morgan	CO
Frederick	CO
Gilcrest	CO
Granby	CO
Greeley	CO
Hayden	CO
Holyoke	CO
Hudson	CO
Johnstown	CO
Julesburg	CO
Keenesburg	CO
Kersey	CO
Kremmling	CO
La Salle	CO
Laporte	CO
Lochbuie	CO
Log Lane Village	CO
Longmont	CO
Loveland	CO
Lyons	CO
Mead	CO
Meeker	CO
Milliken	CO
Niwot	CO
Platteville	CO
Rangely	CO
Severance	CO
Steamboat Springs	CO
Sterling	CO
Wellington	CO
Windsor	CO
Yuma	CO
Aberdeen	ID
American Falls	ID
Ammon	ID
Arco	ID
Ashton	ID
Bellevue	ID
Blackfoot	ID
Boise	ID
Bonners Ferry	ID
Buhl	ID
Burley	ID
Caldwell	ID
Chubbuck	ID
Coeur d'Alene	ID
Cottonwood	ID
Dalton Gardens	ID
Driggs	ID
Eagle	ID
Emmett	ID
Filer	ID
Fort Hall	ID
Fruitland	ID
Garden City	ID
Glenns Ferry	ID
Gooding	ID
Grangeville	ID
Hailey	ID
Hayden	ID
Heyburn	ID
Homedale	ID
Idaho Falls	ID
Iona	ID
Jerome	ID
Kamiah	ID
Kellogg	ID
Ketchum	ID
Kimberly	ID
Kuna	ID
Lapwai	ID
Lewiston	ID
Lewiston Orchards	ID
Malad City	ID
Marsing	ID
McCall	ID
Meridian	ID
Middleton	ID
Montpelier	ID
Moscow	ID
Mountain Home	ID
Nampa	ID
New Plymouth	ID
Orofino	ID
Osburn	ID
Parma	ID
Payette	ID
Pinehurst	ID
Pocatello	ID
Post Falls	ID
Preston	ID
Priest River	ID
Rexburg	ID
Rigby	ID
Rupert	ID
Saint Anthony	ID
Saint Maries	ID
Salmon	ID
Sandpoint	ID
Shelley	ID
Shoshone	ID
Soda Springs	ID
Spirit Lake	ID
Star	ID
Sugar City	ID
Sun Valley	ID
Twin Falls	ID
Victor	ID
Weiser	ID
Wendell	ID
Wilder	ID
Absarokee	MT
Anaconda	MT
Baker	MT
Belgrade	MT
Big Sky	MT
Big Timber	MT
Bigfork	MT
Billings	MT
Boulder	MT
Bozeman	MT
Browning	MT
Butte	MT
Chinook	MT
Choteau	MT
Clancy	MT
Colstrip	MT
Columbia Falls	MT
Columbus	MT
Conrad	MT
Crow Agency	MT
Cut Bank	MT
Deer Lodge	MT
Dillon	MT
East Helena	MT
East Missoula	MT
Eureka	MT
Evergreen	MT
Forsyth	MT
Fort Belknap Agency	MT
Fort Benton	MT
Four Corners	MT
Glasgow	MT
Glendive	MT
Great Falls	MT
Hamilton	MT
Hardin	MT
Havre	MT
Helena	MT
Kalispell	MT
Lakeside	MT
Lame Deer	MT
Laurel	MT
Lewistown	MT
Libby	MT
Lincoln	MT
Livingston	MT
Lockwood	MT
Lolo	MT
Malta	MT
Manhattan	MT
Miles City	MT
Missoula	MT
Montana City	MT
North Browning	MT
Orchard Homes	MT
Pablo	MT
Plains	MT
Plentywood	MT
Polson	MT
Red Lodge	MT
Ronan	MT
Roundup	MT
Scobey	MT
Seeley Lake	MT
Shelby	MT
Sidney	MT
South Browning	MT
Stevensville	MT
Sun Prairie	MT
Thompson Falls	MT
Three Forks	MT
Townsend	MT
West Glendive	MT
West Yellowstone	MT
White Sulphur Springs	MT
Whitefish	MT
Whitehall	MT
Wolf Point	MT
Beulah	ND
Bismarck	ND
Bottineau	ND
Bowman	ND
Burlington	ND
Crosby	ND
Dickinson	ND
Garrison	ND
Hazen	ND
Hettinger	ND
Kenmare	ND
Lincoln	ND
Linton	ND
Mandan	ND
Minot	ND
New Town	ND
Parshall	ND
Stanley	ND
Tioga	ND
Washburn	ND
Watford City	ND
Williston	ND
Alliance	NE
Bayard	NE
Bridgeport	NE
Chadron	NE
Crawford	NE
Gering	NE
Gordon	NE
Gothenburg	NE
Grant	NE
Imperial	NE
Kimball	NE
McCook	NE
Mitchell	NE
North Platte	NE
Ogallala	NE
Scottsbluff	NE
Sidney	NE
Sutherland	NE
Valentine	NE
Battle Mountain	NV
Carlin	NV
Elko	NV
Lovelock	NV
Owyhee	NV
Spring Creek	NV
Wells	NV
West Wendover	NV
Winnemucca	NV
Albany	OR
Aloha	OR
Altamont	OR
Amity	OR
Ashland	OR
Astoria	OR
Athena	OR
Aumsville	OR
Baker City	OR
Bandon	OR
Banks	OR
Barview	OR
Bay City	OR
Beaverton	OR
Bend	OR
Boardman	OR
Brookings	OR
Brownsville	OR
Bunker Hill	OR
Burns	OR
Canby	OR
Cannon Beach	OR
Canyonville	OR
Carlton	OR
Cascade Locks	OR
Cave Junction	OR
Cedar Hills	OR
Cedar Mill	OR
Central Point	OR
Chenoweth	OR
Clackamas	OR
Clatskanie	OR
Columbia City	OR
Coos Bay	OR
Coquille	OR
Cornelius	OR
Corvallis	OR
Cottage Grove	OR
Creswell	OR
Dallas	OR
Dayton	OR
Depoe Bay	OR
Deschutes River Woods	OR
Drain	OR
Dundee	OR
Dunes City	OR
Durham	OR
Eagle Point	OR
Elgin	OR
Enterprise	OR
Estacada	OR
Eugene	OR
Fairview	OR
Falls City	OR
Florence	OR
Forest Grove	OR
Four Corners	OR
Gervais	OR
Gladstone	OR
Glide	OR
Gold Hill	OR
Grants Pass	OR
Green	OR
Gresham	OR
Happy Valley	OR
Harbor	OR
Harrisburg	OR
Hayesville	OR
Heppner	OR
Hermiston	OR
Hillsboro	OR
Hines	OR
Hood River	OR
Hubbard	OR
Independence	OR
Irrigon	OR
Jacksonville	OR
Jefferson	OR
Jennings Lodge	OR
John Day	OR
Junction City	OR
Keizer	OR
King City	OR
Klamath Falls	OR
La Grande	OR
La Pine	OR
Lafayette	OR
Lake Oswego	OR
Lakeside	OR
Lakeview	OR
Lebanon	OR
Lincoln Beach	OR
Lincoln City	OR
Lyons	OR
Madras	OR
McMinnville	OR
Medford	OR
Metzger	OR
Mill City	OR
Milton-Freewater	OR
Milwaukie	OR
Mission	OR
Molalla	OR
Monmouth	OR
Mount Angel	OR
Mount Hood Village	OR
Myrtle Creek	OR
Myrtle Point	OR
Newberg	OR
Newport	OR
North Bend	OR
North Plains	OR
Nyssa	OR
Oak Grove	OR
Oak Hills	OR
Oakridge	OR
Odell	OR
Ontario	OR
Oregon City	OR
Pacific City	OR
Pendleton	OR
Philomath	OR
Phoenix	OR
Pilot Rock	OR
Port Orford	OR
Portland	OR
Prineville	OR
Rainier	OR
Raleigh Hills	OR
Redmond	OR
Redwood	OR
Reedsport	OR
Riddle	OR
Rockcreek	OR
Rockaway Beach	OR
Rogue River	OR
Rose Lodge	OR
Roseburg	OR
Saint Helens	OR
Salem	OR
Sandy	OR
Scappoose	OR
Seaside	OR
Shady Cove	OR
Sheridan	OR
Sherwood	OR
Siletz	OR
Silverton	OR
Sisters	OR
South Lebanon	OR
Springfield	OR
Stanfield	OR
Stayton	OR
Sublimity	OR
Sunnyside	OR
Sutherlin	OR
Sweet Home	OR
Talent	OR
Terrebonne	OR
The Dalles	OR
Three Rivers	OR
Tigard	OR
Tillamook	OR
Toledo	OR
Tri-City	OR
Troutdale	OR
Tualatin	OR
Turner	OR
Umatilla	OR
Union	OR
Vale	OR
Veneta	OR
Vernonia	OR
Waldport	OR
Warm Springs	OR
Warrenton	OR
West Haven	OR
West Linn	OR
West Slope	OR
White City	OR
Willamina	OR
Wilsonville	OR
Winston	OR
Wood Village	OR
Woodburn	OR
Yoncalla	OR
Belle Fourche	SD
Blackhawk	SD
Box Elder	SD
Colonial Pine Hills	SD
Custer	SD
Deadwood	SD
Fort Pierre	SD
Hot Springs	SD
Lead	SD
Lemmon	SD
Martin	SD
Mobridge	SD
North Eagle Butte	SD
North Spearfish	SD
Oglala	SD
Pierre	SD
Pine Ridge	SD
Rapid City	SD
Rapid Valley	SD
Rosebud	SD
Spearfish	SD
Sturgis	SD
Alpine	UT
Benjamin	UT
Benson	UT
Bluffdale	UT
Bountiful	UT
Brigham City	UT
Canyon Rim	UT
Cedar Hills	UT
Centerfield	UT
Centerville	UT
Clearfield	UT
Clinton	UT
Coalville	UT
Cottonwood Heights	UT
Draper	UT
Duchesne	UT
Dugway	UT
Eagle Mountain	UT
East Millcreek	UT
Elk Ridge	UT
Enterprise	UT
Erda	UT
Farmington	UT
Farr West	UT
Fruit Heights	UT
Garland	UT
Granite	UT
Grantsville	UT
Harrisville	UT
Heber City	UT
Herriman	UT
Highland	UT
Holladay	UT
Honeyville	UT
Hooper	UT
Hyde Park	UT
Hyrum	UT
Kamas	UT
Kaysville	UT
Kearns	UT
Layton	UT
Lehi	UT
Lewiston	UT
Lindon	UT
Logan	UT
Maeser	UT
Magna	UT
Mapleton	UT
Marriott-Slaterville	UT
Mendon	UT
Midvale	UT
Midway	UT
Millcreek	UT
Millville	UT
Morgan	UT
Mount Olympus	UT
Murray	UT
Naples	UT
Nibley	UT
North Logan	UT
North Ogden	UT
North Salt Lake	UT
Oakley	UT
Ogden	UT
Oquirrh	UT
Orem	UT
Park City	UT
Payson	UT
Perry	UT
Plain City	UT
Pleasant Grove	UT
Pleasant View	UT
Providence	UT
Provo	UT
Richmond	UT
River Heights	UT
Riverdale	UT
Riverton	UT
Roosevelt	UT
Roy	UT
Salt Lake City	UT
Sandy City	UT
Sandy Hills	UT
Saratoga Springs	UT
Smithfield	UT
South Jordan Heights	UT
South Jordan	UT
South Ogden	UT
South Salt Lake	UT
South Weber	UT
Spanish Fork	UT
Springville	UT
Stansbury park	UT
Summit Park	UT
Sunset	UT
Syracuse	UT
Taylorsville	UT
Tooele	UT
Tremonton	UT
Uintah	UT
Vernal	UT
Washington Terrace	UT
Wendover	UT
West Bountiful	UT
West Haven	UT
West Jordan	UT
West Point	UT
West Valley City	UT
White City	UT
Willard	UT
Willard	UT
Woodland Hills	UT
Woods Cross	UT
Aberdeen	WA
Ahtanum	WA
Airway Heights	WA
Alderwood Manor	WA
Algona	WA
Amboy	WA
Ames Lake	WA
Anacortes	WA
Arlington Heights	WA
Arlington	WA
Artondale	WA
Asotin	WA
Auburn	WA
Barberton	WA
Basin City	WA
Battle Ground	WA
Bellevue	WA
Bellingham	WA
Benton City	WA
Big Lake	WA
Birch Bay	WA
Black Diamond	WA
Blaine	WA
Bonney Lake	WA
Bothell	WA
Bremerton	WA
Brewster	WA
Bridgeport	WA
Brier	WA
Brush Prairie	WA
Buckley	WA
Burbank	WA
Burien	WA
Burlington	WA
Camano	WA
Camas	WA
Carnation	WA
Cascade Valley	WA
Cashmere	WA
Castle Rock	WA
Cathcart	WA
Central Park	WA
Centralia	WA
Chehalis	WA
Chelan	WA
Cheney	WA
Chewelah	WA
Clarkston	WA
Cle Elum	WA
Clear Lake	WA
Clyde Hill	WA
Colfax	WA
College Place	WA
Colville	WA
Connell	WA
Cosmopolis	WA
Cottage Lake	WA
Coulee Dam	WA
Country Homes	WA
Coupeville	WA
Covington	WA
Dallesport	WA
Darrington	WA
Davenport	WA
Dayton	WA
Deer Park	WA
Des Moines	WA
Desert Aire	WA
Dishman	WA
Dollar Corner	WA
DuPont	WA
Duvall	WA
East Port Orchard	WA
East Renton Highlands	WA
East Wenatchee	WA
East Wenatchee Bench	WA
Eastgate	WA
Eatonville	WA
Edgewood	WA
Edmonds	WA
Elk Plain	WA
Ellensburg	WA
Elma	WA
Entiat	WA
Enumclaw	WA
Ephrata	WA
Esperance	WA
Everett	WA
Everson	WA
Fairwood	WA
Fall City	WA
Felida	WA
Federal Way	WA
Ferndale	WA
Fife	WA
Finley	WA
Fircrest	WA
Five Corners	WA
Fords Prairie	WA
Forks	WA
Fox Island	WA
Frederickson	WA
Freeland	WA
Friday Harbor	WA
Garrett	WA
Geneva	WA
Gig Harbor	WA
Gleed	WA
Gold Bar	WA
Goldendale	WA
Graham	WA
Grand Mound	WA
Grandview	WA
Granger	WA
Granite Falls	WA
Granite Falls	WA
Grayland	WA
Highland	WA
Hobart	WA
Hockinson	WA
Hoquiam	WA
Indianola	WA
Issaquah	WA
Kalama	WA
Kelso	WA
Kenmore	WA
Kennewick	WA
Kent	WA
Kettle Falls	WA
Kingston	WA
Kingsgate	WA
Kirkland	WA
Kittitas	WA
La Center	WA
Lacey	WA
Lake Forest Park	WA
Lake Goodwin	WA
Lake Ketchum	WA
Lake Shore	WA
Lake Stevens	WA
Lakewood	WA
Langley	WA
Leavenworth	WA
Lewisville	WA
Liberty Lake	WA
Lochsloy	WA
Long Beach	WA
Longview	WA
Longview Heights	WA
Lynden	WA
Lynnwood	WA
Mabton	WA
Machias	WA
Maltby	WA
Manchester	WA
Maple Valley	WA
Marietta	WA
Martha Lake	WA
Marysville	WA
Mattawa	WA
May Creek	WA
McCleary	WA
Meadow Glade	WA
Medical Lake	WA
Medina	WA
Mercer Island	WA
Midland	WA
Mill Creek	WA
Mill Plain	WA
Millwood	WA
Milton	WA
Minnehaha	WA
Mirrormont	WA
Monroe	WA
Montesano	WA
Morton	WA
Moses Lake	WA
Mount Vernon	WA
Mount Vista	WA
Mountlake Terrace	WA
Mukilteo	WA
Napavine	WA
Navy Yard City	WA
Newcastle	WA
Newport	WA
Newport	WA
Normandy Park	WA
North Bend	WA
North Creek	WA
North Marysville	WA
North Yelm	WA
Oak Harbor	WA
Ocean Park	WA
Ocean Shores	WA
Okanogan	WA
Olympia	WA
Omak	WA
Opportunity	WA
Orchards	WA
Oroville	WA
Orting	WA
Othello	WA
Pacific	WA
Parkland	WA
Parkwood	WA
Pasco	WA
Pomeroy	WA
Port Angeles	WA
Port Ludlow	WA
Port Orchard	WA
Port Townsend	WA
Poulsbo	WA
Prairie Ridge	WA
Prosser	WA
Pullman	WA
Puyallup	WA
Quincy	WA
Rainier	WA
Raymond	WA
Redmond	WA
Renton	WA
Richland	WA
Ridgefield	WA
Riverbend	WA
Ritzville	WA
Rochester	WA
Roy	WA
Royal City	WA
Salmon Creek	WA
Sammamish	WA
SeaTac	WA
Seattle	WA
Sedro-Woolley	WA
Selah	WA
Sequim	WA
Shelton	WA
Shoreline	WA
Silverdale	WA
Smokey Point	WA
Snohomish	WA
Snoqualmie	WA
Soap Lake	WA
South Bend	WA
South Hill	WA
Spanaway	WA
Spokane	WA
Stanwood	WA
Steilacoom	WA
Stevenson	WA
Sudden Valley	WA
Sultan	WA
Sumas	WA
Summit	WA
Sumner	WA
Sunnyside	WA
Sunnyslope	WA
Suquamish	WA
Tacoma	WA
Tanner	WA
Tenino	WA
Terrace Heights	WA
Three Lakes	WA
Tieton	WA
Toppenish	WA
Town and Country	WA
Tracyton	WA
Trentwood	WA
Tukwila	WA
Tulalip Bay	WA
Tumwater	WA
Union Gap	WA
University Place	WA
Vancouver	WA
Vashon	WA
Veradale	WA
Venersborg	WA
Waitsburg	WA
Walla Walla	WA
Waller	WA
Walnut Grove	WA
Wapato	WA
Warden	WA
Warm Beach	WA
Washougal	WA
Waterville	WA
Wenatchee	WA
West Lake Sammamish	WA
West Lake Stevens	WA
West Longview	WA
West Pasco	WA
West Richland	WA
West Valley	WA
West Wenatchee	WA
Westport	WA
White Center	WA
White Salmon	WA
White Swan	WA
Winlock	WA
Bainbridge Island	WA
Woodinville	WA
Woodland	WA
Woods Creek	WA
Woodway	WA
Yacolt	WA
Yakima	WA
Yelm	WA
Zillah	WA
Afton	WY
Arapahoe	WY
Bar Nunn	WY
Basin	WY
Buffalo	WY
Casper	WY
Cheyenne	WY
Cody	WY
Douglas	WY
Ethete	WY
Evanston	WY
Evansville	WY
Fort Washakie	WY
Gillette	WY
Glenrock	WY
Green River	WY
Greybull	WY
Guernsey	WY
Hoback	WY
Jackson	WY
Kemmerer	WY
Lander	WY
Laramie	WY
Lovell	WY
Lusk	WY
Lyman	WY
Mills	WY
Moose Wilson Road	WY
Mountain View	WY
Newcastle	WY
North Rock Springs	WY
Pine Bluffs	WY
Pinedale	WY
Powell	WY
Rafter J Ranch	WY
Ranchettes	WY
Rawlins	WY
Riverton	WY
Rock Springs	WY
Saratoga	WY
Sheridan	WY
Sleepy Hollow	WY
South Greeley	WY
Sundance	WY
Thermopolis	WY
Torrington	WY
Wheatland	WY
Wilson	WY
Worland	WY
Wright	WY
Gold Beach	OR
American Fork	UT
Craig	AK
Haines	AK
Kahalu‘u	HI
Kahuku	HI
Kahului	HI
Kailua	HI
Kailua-Kona	HI
Kalaheo	HI
Kalaoa	HI
Kāne‘ohe	HI
Kapaa	HI
Kapaau	HI
Kaunakakai	HI
Kea‘au	HI
Kealakekua	HI
Kekaha	HI
Kīhei	HI
Kilauea	HI
Koloa	HI
Kualapu‘u	HI
Kurtistown	HI
Lahaina	HI
Lā‘ie	HI
Lāna‘i City	HI
Lawai	HI
Leilani Estates	HI
Lihue	HI
Mā‘ili	HI
Mākaha	HI
Mākaha Valley	HI
Makakilo City	HI
Makawao	HI
Maunawili	HI
Mililani Town	HI
Mokuleia	HI
Mountain View	HI
Nānākuli	HI
Nanawale Estates	HI
Omao	HI
Orchidlands Estates	HI
Pāhala	HI
Paia	HI
Pāpa‘ikou	HI
Pearl City	HI
Pepeekeo	HI
Poipu	HI
Princeville	HI
Puhi	HI
Pukalani	HI
Punaluu	HI
Pūpūkea	HI
Village Park	HI
Volcano	HI
Wahiawā	HI
Waialua	HI
Waialua	HI
Wai‘anae	HI
Waikapu	HI
Waikoloa Village	HI
Wailua	HI
Wailua	HI
Wailuku	HI
Waimalu	HI
Waimānalo	HI
Waimānalo Beach	HI
Waimea	HI
Waimea	HI
Wainaku	HI
Waipahu	HI
Waipi‘o	HI
Waipi‘o Acres	HI
Whitmore Village	HI
Eleele	HI
‘Ewa Beach	HI
‘Ewa Gentry	HI
‘Ewa Villages	HI
Hālawa	HI
Hālawa Heights	HI
Hale‘iwa	HI
Hanamaulu	HI
Hanapēpē	HI
Hanapepe Heights	HI
Hau‘ula	HI
Hawaiian Beaches	HI
Hawaiian Acres	HI
Hawaiian Paradise Park	HI
Hawaiian Ocean View	HI
He‘eia	HI
Hilo	HI
Hōlualoa	HI
Honalo	HI
Honoka‘a	HI
Honolulu	HI
‘Aiea	HI
‘Āhuimanu	HI
Iroquois Point	HI
Kaaawa	HI
Kā‘anapali	HI
Kaanapali Landing	HI
Ainaloa	HI
Anahola	HI
Captain Cook	HI
Butte	AK
Cohoe	AK
College	AK
Cordova	AK
Diamond Ridge	AK
Dillingham	AK
Ester	AK
Fairbanks	AK
Fritz Creek	AK
Gateway	AK
Healy	AK
Homer	AK
Hooper Bay	AK
Houston	AK
Kalifornsky	AK
Kenai	AK
Kodiak	AK
Kotzebue	AK
Lazy Mountain	AK
Meadow Lakes	AK
Nikiski	AK
Nome	AK
North Pole	AK
Palmer	AK
Ridgeway	AK
Seward	AK
Soldotna	AK
Sterling	AK
Talkeetna	AK
Tanaina	AK
Tok	AK
Unalaska	AK
Valdez	AK
Wasilla	AK
Willow	AK
Anchorage	AK
Anchor Point	AK
Barrow	AK
Bear Creek	AK
Bethel	AK
Big Lake	AK
St Johnsbury	VT
Dayton	ME
Village of Campton Hills	IL
Baywood	NY
